22 32 10
Level 0
7 7 7 7 7 7 7 7 7 7 7 7 7 7 7 7 7 7 7 7 7 7
7 7 7 7 7 7 7 7 7 7 7 7 7 7 7 7 7 7 7 7 7 7
7 7 7 7 7 7 7 7 7 7 7 7 7 7 7 7 7 7 7 7 7 7
7 7 7 7 7 7 7 7 7 7 7 7 7 7 7 7 7 7 7 7 7 7
7 7 7 7 7 7 7 7 7 7 7 7 7 7 7 7 7 7 7 7 7 7
7 7 7 7 7 7 7 7 7 7 7 7 7 7 7 7 7 7 7 7 7 7
7 7 7 7 7 7 7 7 7 7 7 7 7 7 7 7 7 7 7 7 7 7
7 7 7 7 7 7 7 7 7 7 7 7 7 7 7 7 7 7 7 7 7 7
7 7 7 7 7 7 7 7 7 7 7 7 7 7 7 7 7 7 7 7 7 7
7 7 7 7 7 7 7 7 7 7 7 7 7 7 7 7 7 7 7 7 7 7
7 7 7 7 7 7 7 7 7 7 7 7 7 7 7 7 7 7 7 7 7 7
7 7 7 7 7 7 7 7 7 7 7 7 7 7 7 7 7 7 7 7 7 7
7 7 7 7 7 7 7 7 7 7 7 7 7 7 7 7 7 7 7 7 7 7
7 7 7 7 7 7 7 7 7 7 7 7 7 7 7 7 7 7 7 7 7 7
7 7 7 7 7 7 7 7 7 7 7 7 7 7 7 7 7 7 7 7 7 7
7 7 7 7 7 7 7 7 7 7 7 7 7 7 7 7 7 7 7 7 7 7
7 7 7 7 7 7 7 7 7 7 7 7 7 7 7 7 7 7 7 7 7 7
7 7 7 7 7 7 7 7 7 7 7 7 7 7 7 7 7 7 7 7 7 7
7 7 7 7 7 7 7 7 7 7 7 7 7 7 7 7 7 7 7 7 7 7
7 7 7 7 7 7 7 7 7 7 7 7 7 7 7 7 7 7 7 7 7 7
7 7 7 7 7 7 7 7 7 7 7 7 7 7 7 7 7 7 7 7 7 7
7 7 7 7 7 7 7 7 7 7 7 7 7 7 7 7 7 7 7 7 7 7
7 7 7 7 7 7 7 7 7 7 7 7 7 7 7 7 7 7 7 7 7 7
7 7 7 7 7 7 7 7 7 7 7 7 7 7 7 7 7 7 7 7 7 7
7 7 7 7 7 7 7 7 7 7 7 7 7 7 7 7 7 7 7 7 7 7
7 7 7 7 7 7 7 7 7 7 7 7 7 7 7 7 7 7 7 7 7 7
7 7 7 7 7 7 7 7 7 7 7 7 7 7 7 7 7 7 7 7 7 7
7 7 7 7 7 7 7 7 7 7 7 7 7 7 7 7 7 7 7 7 7 7
7 7 7 7 7 7 7 7 7 7 7 7 7 7 7 7 7 7 7 7 7 7
7 7 7 7 7 7 7 7 7 7 7 7 7 7 7 7 7 7 7 7 7 7
7 7 7 7 7 7 7 7 7 7 7 7 7 7 7 7 7 7 7 7 7 7
7 7 7 7 7 7 7 7 7 7 7 7 7 7 7 7 7 7 7 7 7 7
Level 1
7 7 7 7 7 7 7 7 7 7 7 7 7 7 7 7 7 7 7 7 7 7
7 7 7 7 7 7 7 7 7 7 7 7 7 7 7 7 7 7 7 7 7 7
7 7 7 7 7 7 7 7 7 7 7 7 7 7 7 7 7 7 7 7 7 7
7 7 7 7 7 7 7 7 7 7 7 7 7 7 7 7 7 7 7 7 7 7
7 7 7 7 7 7 7 7 7 7 7 7 7 7 7 7 7 7 7 7 7 7
7 7 7 7 7 7 7 7 7 7 7 7 7 7 7 7 7 7 7 7 7 7
7 7 7 7 7 7 7 7 7 7 7 7 7 7 7 7 7 7 7 7 7 7
7 7 7 7 7 7 7 7 7 7 7 7 7 7 7 7 7 7 7 7 7 7
7 7 7 7 7 7 7 7 7 7 7 7 7 7 7 7 7 7 7 7 7 7
7 7 7 7 7 7 7 7 7 7 7 7 7 7 7 7 7 7 7 7 7 7
7 7 7 7 7 7 7 7 7 7 7 7 7 7 7 7 7 7 7 7 7 7
7 7 7 7 7 7 7 7 7 7 7 7 7 7 7 7 7 7 7 7 7 7
7 7 7 7 7 7 7 7 7 7 7 7 7 7 7 7 7 7 7 7 7 7
7 7 7 7 7 7 7 7 7 7 7 7 7 7 7 7 7 7 7 7 7 7
7 7 7 7 7 7 7 7 7 7 7 7 7 7 7 7 7 7 7 7 7 7
7 7 7 7 7 7 7 7 7 7 7 7 7 7 7 7 7 7 7 7 7 7
7 7 7 7 7 7 7 7 7 7 7 7 7 7 7 7 7 7 7 7 7 8
7 7 7 7 7 7 7 7 7 7 7 7 7 7 7 7 7 8 8 8 8 8
7 7 7 7 7 7 7 7 7 7 7 7 8 8 8 8 8 8 8 8 8 8
7 7 7 7 7 7 7 7 7 7 7 7 8 8 8 8 8 8 8 39 8 8
7 7 7 7 7 7 7 7 7 7 7 7 8 8 8 8 38 49 8 8 8 8
7 7 7 7 7 7 7 7 7 7 7 7 8 8 8 8 39 48 38 49 8 8
7 7 7 7 7 7 7 7 7 7 7 7 8 8 8 49 38 36 37 39 8 8
7 7 7 7 7 7 7 7 7 7 7 7 8 8 8 39 36 83 38 48 8 8
7 7 7 7 7 7 7 7 7 7 7 7 8 8 8 8 39 38 49 8 8 8
7 7 7 7 7 7 7 7 7 7 7 7 8 8 8 48 48 39 48 38 8 8
7 7 7 7 7 7 7 7 7 7 7 7 8 8 8 8 8 36 37 39 8 8
7 7 7 7 7 7 7 7 7 7 7 7 8 8 8 8 8 38 8 8 8 8
7 7 7 7 7 7 7 7 7 7 7 7 8 8 8 39 8 8 8 39 8 8
7 7 7 7 7 7 7 7 7 7 7 7 7 7 7 8 8 8 8 8 8 8
7 7 7 7 7 7 7 7 7 7 7 7 7 7 7 8 8 8 8 8 8 8
7 7 7 7 7 7 7 7 7 7 7 7 7 7 8 8 8 8 8 8 8 8
Level 2
8 8 8 8 8 8 8 8 8 8 8 8 8 8 8 8 8 8 8 8 8 8
8 8 8 8 8 8 8 8 8 8 8 8 8 8 8 8 8 8 8 8 8 8
8 8 8 8 8 8 8 8 8 8 8 8 8 8 8 8 8 8 8 8 8 8
8 8 8 8 8 8 8 8 8 8 8 8 8 8 8 8 8 8 8 8 8 8
8 8 8 8 8 8 8 8 8 8 8 8 8 8 8 8 8 8 8 8 8 8
8 8 8 8 8 8 8 8 8 8 8 8 8 8 8 8 8 8 8 8 8 8
8 8 8 8 8 8 8 8 8 8 8 8 8 8 8 8 8 8 8 8 8 8
8 8 8 8 8 8 8 8 8 8 8 8 8 8 8 8 8 8 8 8 8 8
8 8 8 8 8 8 8 8 8 8 8 8 8 8 8 8 8 8 8 8 8 8
8 8 8 8 8 8 8 8 8 8 8 8 8 8 8 8 8 8 8 8 8 8
8 8 8 8 8 8 8 8 8 8 8 8 8 8 8 8 8 8 8 8 8 8
8 8 8 8 8 8 8 8 8 8 8 8 8 8 8 8 8 8 8 8 8 8
8 8 8 8 8 8 8 8 8 8 8 8 8 8 8 8 8 8 8 8 8 8
8 8 8 8 8 8 8 8 8 8 8 8 8 8 8 8 8 8 8 8 8 8
8 8 8 8 8 8 8 8 8 8 8 8 8 8 8 8 8 8 8 8 8 8
8 8 8 8 8 8 8 8 8 8 8 8 8 8 8 8 8 8 8 8 8 8
8 8 8 8 8 8 8 8 8 8 8 8 8 8 39 8 8 37 8 8 8 .
8 8 8 103 8 8 8 8 8 8 8 8 8 8 8 8 49 8 23 23 20/type=13 .
8 39 103 103 103 103 103 8 8 8 8 8 8 39 8 30 20 30 23 102 . .
8 8 103 103 103 103 103 103 39 8 8 8 8 8 36 20/type=9 20/type=2 20/type=2 20/type=31 . . .
8 8 103 103 103 103 103 103 8 8 8 8 8 38 49 20/type=1 . . 100 . . .
8 8 8 103 103 103 103 103 103 8 8 8 39 8 20/type=9 20/type=5 . . . . . .
8 8 8 103 103 103 103 103 103 8 8 8 8 29 20/type=1 . . . . . . .
8 8 8 8 103 103 103 103 8 8 8 8 8 36 20/type=1 . . . . . . .
8 8 8 8 8 103 103 8 8 8 8 8 8 29 20/type=12 20/type=8 . . . . . .
8 8 8 8 19 8 39 8 8 8 8 8 8 39 20 20/type=1 . . . . . .
8 8 8 8 8 8 8 8 8 8 8 8 8 38 46 20/type=1 . . . . . .
8 8 8 8 8 8 8 8 8 8 8 8 8 8 23 20/type=29 . . . . . .
8 8 8 8 8 8 8 8 8 8 8 8 8 39 23 . . 102 . . . .
8 8 8 8 8 8 8 8 8 8 8 8 8 8 39 . . . . . . .
8 8 8 8 8 8 8 8 8 8 8 8 8 8 8 . . . . . . .
8 8 8 8 8 8 8 8 8 8 8 8 8 8 . . . . . . . .
Level 3
8 8 8 8 8 8 8 8 8 8 8 8 8 8 8 8 8 8 8 8 . .
8 8 8 8 8 8 8 8 8 8 8 8 8 8 8 8 8 8 8 8 . .
8 8 8 8 8 8 8 8 8 8 8 8 8 8 8 8 8 8 8 8 . .
8 8 8 8 8 8 8 8 8 8 8 8 8 8 8 8 8 8 8 8 . .
8 8 8 8 8 8 8 8 8 8 8 8 8 8 8 8 8 8 8 8 . .
8 8 8 8 8 8 8 8 8 8 8 8 8 8 8 8 8 8 8 8 . .
8 8 8 8 8 8 8 8 8 8 8 8 8 8 8 8 8 8 8 8 . .
8 8 8 8 8 8 8 8 8 8 8 8 8 8 8 8 8 8 8 8 . .
8 8 8 8 8 8 8 8 8 8 8 8 8 8 8 8 8 8 8 8 . .
8 8 8 8 8 8 8 8 8 8 8 8 8 8 8 8 8 8 8 8 . .
8 8 8 8 8 8 8 8 8 8 8 8 8 8 8 8 8 8 8 8 . .
8 8 8 8 8 8 8 8 8 8 8 8 8 8 8 8 8 8 8 8 . .
8 . . 8 8 8 8 8 8 8 8 8 8 8 8 8 8 8 8 . . .
. . . . 8 . 8 8 8 8 8 8 8 8 8 8 . 8 . . . .
. . . . . 102 . . 8 8 8 8 8 . 8 . . 9 17 . . .
. . . 9 . 17 . . . . 8 8 . . . 9 17 9 101 . . .
. . 19 100 17 9 17 17 . . . . . 19 . . . . . . . .
. . 102 . . . 102 . 9 102 . . . . . . . . . . . .
. . . . . . . . 17 . . . e1 . . . . . . . . .
. . . . . . . . . . . . . . . . . . . . . .
. 102 . . . . . . . . . . . . . . . . . . . .
. 101 . . . . . . . . 99/texts={"Si quelqu'un lit ce message...","Alors il n'est pas trop tard.","Notre monde s'effondre.","Plus rien ne fait sens.","Ne te perds pas..."} . . . . . . . . . . .
17 . . . . . . . . . . . . . . . . . . . . .
9 . 19 . . . . . . . . . . . . . . . . . . .
. 17 . . . . . . . . 3 . . . . . . . . . . .
. 17 17 . . . . . . . . . . . . . . . . . . .
. . 9 . . . . . . . . . . . . . . . . . . .
. . 102 101 9 100 . . . . p . . . . . . . . . . .
. . . . . 17 102 . . . . . . . . . . . . . . .
. . . . . . . . . . . . . . . . . . . . . .
. . . . . . . . . . . . . . . . . . . . . .
. . . . . . . . . . . . . . . . . . . . . .
Level 4
8 8 8 8 8 8 8 8 8 8 8 8 8 8 8 8 . . . . . .
8 8 8 8 8 8 8 8 8 8 38 8 8 8 8 8 . . . . . .
8 8 8 8 8 8 8 8 8 8 8 20 38 8 8 8 8 . . . . .
8 8 8 8 8 8 8 8 8 8 39 20 20 8 8 8 8 . . . . .
8 8 8 8 8 8 8 8 8 28 8 47 8 38 8 8 8 8 . . . .
8 8 8 8 8 8 8 8 8 37 8 8 8 8 8 8 8 8 . . . .
8 8 8 8 8 8 8 8 8 8 8 8 8 8 8 8 8 . . . . .
8 8 8 8 8 27 8 8 8 28 8 8 8 8 8 8 8 . . . . .
8 8 8 8 8 8 27 27 8 8 8 8 8 8 8 8 . . 101 . . .
8 . 8 8 8 38 8 8 39 8 8 8 8 8 8 . . . . . . .
. 102 . . 8 8 8 38 8 8 8 8 8 8 . . . . 102 . . .
. 100 . . . 8 48 8 8 8 8 8 101 . . . 19 . . . . .
. . . . 101 . . 8 8 . 8 . . . 102 . 101 . . . . .
. . . . . . . . . . . . . . . . . . . . . .
. . . . . . . . . . . . . . . . . . . . . .
. . . . . . . . . . . . . . . . . . . . . .
. . 19 . . . . . . . . . . 19 . . . . . . . .
. . . . . . . . . . . . . . . . . . . . . .
. . . . . . . . . . . . . . . . . . . . . .
. . . . . . . . . . . . . . . . . . . . . .
. . . . . . . . . . . . . . . . . . . . . .
. . . . . . . . . . . . . . . . . . . . . .
. . . . . . . . . . . . . . . . . . . . . .
. . . . . . . . . . . . . . . . . . . . . .
. . . . . . . . . . . . . . . . . . . . . .
. . . . . . . . . . . . . . . . . . . . . .
. . . . . . . . . . . . . . . . . . . . . .
. . . . . . . . . . . . . . . . . . . . . .
. . . . . . . . . . . . . . . . . . . . . .
. . . . . . . . . . . . . . . . . . . . . .
. . . . . . . . . . . . . . . . . . . . . .
. . . . . . . . . . . . . . . . . . . . . .
Level 5
. . . . . . . . . . . . . . . . . . . . . .
. . . . . 26 . . 26 . . . . . . . . . . . . .
. . 25 . . . . . . . . . . . 100 . . . . . . .
. . . . 20/type=7 20/type=4 20/type=4 20/type=4 20/type=8 101 . 3 . . . . . . . . . .
. 25 . . 20/type=3 36 20 20 20/type=1 . . . . . 102 . . . . . . .
. 102 . . 20/type=3 20 12/world="chapter1/1-2.txt" 20 35/type=1 . . . . . . . . 102 . . . .
. . . . 20/type=3 20 47 20 20/type=1 . . . . . . . . . . . . .
. . 26 . 20/type=6 20/type=2 35/type=2 20/type=2 20/type=5 . . . . . . . . . . . . .
. 101 . . . . . . . . . . . . . . . . . . . .
. . . . . . . . . . . . . . . . . . . . . .
. . . . . . . . . . . . . . . . . . . . . .
. . . . . . . . . . . . . . . . 19 . . . . .
. . . . . . . . . . . . . . . . . . . . . .
. . . . . . . . . . . . . . . . . . . . . .
. . . . . . . . . . . . . . . . . . . . . .
. . . . . . . . . . . . . . . . . . . . . .
. . 19 . . . . . . . . . . 19 . . . . . . . .
. . . . . . . . . . . . . . . . . . . . . .
. . . . . . . . . . . . . . . . . . . . . .
. . . . . . . . . . . . . . . . . . . . . .
. . . . . . . . . . . . . . . . . . . . . .
. . . . . . . . . . . . . . . . . . . . . .
. . . . . . . . . . . . . . . . . . . . . .
. . . . . . . . . . . . . . . . . . . . . .
. . . . . . . . . . . . . . . . . . . . . .
. . . . . . . . . . . . . . . . . . . . . .
. . . . . . . . . . . . . . . . . . . . . .
. . . . . . . . . . . . . . . . . . . . . .
. . . . . . . . . . . . . . . . . . . . . .
. . . . . . . . . . . . . . . . . . . . . .
. . . . . . . . . . . . . . . . . . . . . .
. . . . . . . . . . . . . . . . . . . . . .
Level 6
. . . . . . . . . . . . . . . . . . . . . .
. . . . . 25 . . . . . . . . . . . . . . . .
. . 26 . . . . . . . . . . . . . . . . . . .
. . . . . . . . . . . . . . . . . . . . . .
. . . . . . . . . . . . . . . . . . . . . .
. . . . . . . . . . . . . . . . . . . . . .
. . . . . . . . . . . . . . . . . . . . . .
. . . . . . . . . . . . . . . . . . . . . .
. . . . . . . . . . . . . . . . . . . . . .
. . . . . . . . . . . . . . . . . . . . . .
. . . . . . . . . . . . . . . . . . . . . .
. . . . . . . . . . . . . . . . 19 . . . . .
. . . . . . . . . . . . . . . . . . . . . .
. . . . . . . . . . . . . . . . . . . . . .
. . . . . . . . . . . . . 17 . . . . . . . .
. 17 17 17 . . . . . . . . 17 17 17 . . . . . . .
. 17 . 17 . . . . . . . 17 17 . 17 17 . . . . . .
. 17 17 17 . . . . . . . . 17 17 17 . . . . . . .
. . . . . . . . . . . . . 17 . . . . . . . .
. . . . . . . . . . . . . . . . . . . . . .
. . . . . . . . . . . . . . . . . . . . . .
. . . . . . . . . . . . . . . . . . . . . .
. . . . . . . . . . . . . . . . . . . . . .
. . . . . . . . . . . . . . . . . . . . . .
. . . . . . . . . . . . . . . . . . . . . .
. . . . . . . . . . . . . . . . . . . . . .
. . . . . . . . . . . . . . . . . . . . . .
. . . . . . . . . . . . . . . . . . . . . .
. . . . . . . . . . . . . . . . . . . . . .
. . . . . . . . . . . . . . . . . . . . . .
. . . . . . . . . . . . . . . . . . . . . .
. . . . . . . . . . . . . . . . . . . . . .
Level 7
. . . . . . . . . . . . . . . . . . . . . .
. . . . . . . . . . . . . . . . . . . . . .
. . . . . . . . . . . . . . . . . . . . . .
. . . . . . . . . . . . . . . . . . . . . .
. . . . . . . . . . . . . . . . . . . . . .
. . . . . . . . . . . . . . . . . . . . . .
. . . . . . . . . . . . . . . . . . . . . .
. . . . . . . . . . . . . . . . . . . . . .
. . . . . . . . . . . . . . . . . . . . . .
. . . . . . . . . . . . . . . . . . . . . .
. . . . . . . . . . . . . . . 17 17 17 . . . .
. . . . . . . . . . . . . . . 17 . 17 . . . .
. . . . . . . . . . . . . . . 17 17 17 . . . .
. . . . . . . . . . . . . . . . . . . . . .
. . . . . . . . . . . . . . . . . . . . . .
. . 17 . . . . . . . . . . 17 . . . . . . . .
. 17 17 17 . . . . . . . . 17 17 17 . . . . . . .
. . 17 . . . . . . . . . . 17 . . . . . . . .
. . . . . . . . . . . . . . . . . . . . . .
. . . . . . . . . . . . . . . . . . . . . .
. . . . . . . . . . . . . . . . . . . . . .
. . . . . . . . . . . . . . . . . . . . . .
. . . . . . . . . . . . . . . . . . . . . .
. . . . . . . . . . . . . . . . . . . . . .
. . . . . . . . . . . . . . . . . . . . . .
. . . . . . . . . . . . . . . . . . . . . .
. . . . . . . . . . . . . . . . . . . . . .
. . . . . . . . . . . . . . . . . . . . . .
. . . . . . . . . . . . . . . . . . . . . .
. . . . . . . . . . . . . . . . . . . . . .
. . . . . . . . . . . . . . . . . . . . . .
. . . . . . . . . . . . . . . . . . . . . .
Level 8
. . . . . . . . . . . . . . . . . . . . . .
. . . . . . . . . . . . . . . . . . . . . .
. . . . . . . . . . . . . . . . . . . . . .
. . . . . . . . . . . . . . . . . . . . . .
. . . . . . . . . . . . . . . . . . . . . .
. . . . . . . . . . . . . . . . . . . . . .
. . . . . . . . . . . . . . . . . . . . . .
. . . . . . . . . . . . . . . . . . . . . .
. . . . . . . . . . . . . . . . . . . . . .
. . . . . . . . . . . . . . . . . . . . . .
. . . . . . . . . . . . . . . . 17 . . . . .
. . . . . . . . . . . . . . . 17 17 17 . . . .
. . . . . . . . . . . . . . . . 17/ambientSound="ambient/nature-background-loop.wav" . . . . .
. . . . . . . . . . . . . . . . . . . . . .
. . . . . . . . . . . . . . . . . . . . . .
. . . . . . . . . . . . . . . . . . . . . .
. . . . . . . . . . . . . . . . . . . . . .
. . . . . . . . . . . . . . . . . . . . . .
. . . . . . . . . . . . . . . . . . . . . .
. . . . . . . . . . . . . . . . . . . . . .
. . . . . . . . . . . . . . . . . . . . . .
. . . . . . . . . . . . . . . . . . . . . .
. . . . . . . . . . . . . . . . . . . . . .
. . . . . . . . . . . . . . . . . . . . . .
. . . . . . . . . . . . . . . . . . . . . .
. . . . . . . . . . . . . . . . . . . . . .
. . . . . . . . . . . . . . . . . . . . . .
. . . . . . . . . . . . . . . . . . . . . .
. . . . . . . . . . . . . . . . . . . . . .
. . . . . . . . . . . . . . . . . . . . . .
. . . . . . . . . . . . . . . . . . . . . .
. . . . . . . . . . . . . . . . . . . . . .
Level 9
5/ambientSound="ambient/moon-origin-loop.wav" . . . . . . . . . . . . . . . . . . . . .
. . . . . . . . . . . . . . . . . . . . . .
. . . . . . . . . . . . . . . . . . . . . .
. . . . . . . . . . . . . . . . . . . . . .
. . . . . . . . . . . . . . . . . . . . . .
. . . . . . . . . . . . . . . . . . . . . .
. . . . . . . . . . . . . . . . . . . . . .
. . . . . . . . . . . . . . . . . . . . . .
. . . . . . . . . . . . . . . . . . . . . .
. . . . . . . . . . . . . . . . . . . . . .
. . . . . . . . . . . . . . . . . . . . . .
. . . . . . . . . . . . . . . . . . . . . .
. . . . . . . . . . . . . . . . . . . . . .
. . . . . . . . . . . . . . . . . . . . . .
. . . . . . . . . . . . . . . . . . . . . .
. . . . . . . . . . . . . . . . . . . . . .
. . . . . . . . . . . . . . . . . . . . . .
. . . . . . . . . . . . . . . . . . . . . .
. . . . . . . . . . . . . . . . . . . . . .
. . . . . . . . . . . . . . . . . . . . . .
. . . . . . . . . . . . . . . . . . . . . .
. . . . . . . . . . . . . . . . . . . . . .
. . . . . . . . . . . . . . . . . . . . . .
. . . . . . . . . . . . . . . . . . . . . .
. . . . . . . . . . . . . . . . . . . . . .
. . . . . . . . . . . . . . . . . . . . . .
. . . . . . . . . . . . . . . . . . . . . .
. . . . . . . . . . . . . . . . . . . . . .
. . . . . . . . . . . . . . . . . . . . . .
. . . . . . . . . . . . . . . . . . . . . .
. . . . . . . . . . . . . . . . . . . . . .
. . . . . . . . . . . . . . . . . . . . . .
