22 32 10
Level 0
8 8 8 8 8 8 8 8 8 8 8 8 8 8 8 8 8 8 8 8 8 8
8 8 8 8 8 8 8 8 8 8 8 8 8 8 8 8 8 8 8 8 8 8
8 8 8 8 8 8 8 8 8 8 8 8 8 8 8 8 8 8 8 8 8 8
8 8 8 8 8 8 8 8 8 8 8 8 8 8 8 8 8 8 8 8 8 8
8 8 8 8 8 8 8 8 8 8 8 8 8 8 8 8 8 8 8 8 8 8
8 8 8 8 8 8 8 8 8 8 8 8 8 8 8 8 8 8 8 8 8 8
8 8 8 8 8 8 8 8 8 8 8 8 8 8 8 8 8 8 8 8 8 8
8 8 8 8 8 8 8 8 8 8 8 8 8 8 8 8 8 8 8 8 8 8
8 8 8 8 8 8 8 8 8 8 8 8 8 8 8 8 8 8 8 8 8 8
8 8 8 8 8 8 8 8 8 8 8 8 8 8 8 8 8 8 8 8 8 8
8 8 8 8 8 8 8 8 8 8 8 8 8 8 8 8 8 8 8 8 8 8
8 8 8 8 8 8 8 8 8 8 8 8 8 8 8 8 8 8 8 8 8 8
8 8 8 8 8 8 8 8 8 8 8 8 8 8 8 8 8 8 8 8 8 8
8 8 8 8 8 8 8 8 8 8 8 8 8 8 8 8 8 8 8 8 8 8
8 8 8 8 8 8 8 8 8 8 8 8 8 8 8 8 8 8 8 8 8 8
8 8 8 8 8 8 8 8 8 8 8 8 8 8 8 8 8 8 8 8 8 8
8 8 8 8 8 8 8 8 8 8 8 8 8 8 8 8 8 8 8 8 8 8
8 8 8 8 8 8 8 8 8 8 8 8 8 8 8 8 8 8 8 8 8 8
8 8 8 8 8 8 8 8 8 8 8 8 8 8 8 8 8 8 8 8 8 8
8 8 8 8 8 8 8 8 8 8 8 8 8 8 8 8 8 8 8 8 8 8
8 8 8 8 8 8 8 8 8 8 8 8 8 8 8 8 8 8 8 8 8 8
8 8 8 8 8 8 8 8 8 8 8 8 8 8 8 8 8 8 8 8 8 8
8 8 8 8 8 8 8 8 8 8 8 8 8 8 8 8 8 8 8 8 8 8
8 8 8 8 8 8 8 8 8 8 8 8 8 8 8 8 8 8 8 8 8 8
8 8 8 8 8 8 8 8 8 8 8 8 8 8 8 8 8 8 8 8 8 8
8 8 8 8 8 8 8 8 8 8 8 8 8 8 8 8 8 8 8 8 8 8
8 8 8 8 8 8 8 8 8 8 8 8 8 8 8 8 8 8 8 8 8 8
8 8 8 8 8 8 8 8 8 8 8 8 8 8 8 8 8 8 8 8 8 8
8 8 8 8 8 8 8 8 8 8 8 8 8 8 8 8 8 8 8 8 8 8
8 8 8 8 8 8 8 8 8 8 8 8 8 8 8 8 8 8 8 8 8 8
8 8 8 8 8 8 8 8 8 8 8 8 8 8 8 8 8 8 8 8 8 8
8 8 8 8 8 8 8 8 8 8 8 8 8 8 8 8 8 8 8 8 8 8
Level 1
8 8 8 8 8 8 8 8 8 8 8 8 8 8 8 8 8 8 8 8 8 8
8 8 8 8 8 8 8 8 8 8 8 8 8 8 8 8 8 8 8 8 8 8
8 8 8 8 8 8 8 8 8 8 8 8 8 8 8 8 8 8 8 8 8 8
8 8 8 8 8 8 8 8 8 8 8 8 8 8 8 8 8 8 8 8 8 8
8 8 8 8 8 8 8 8 8 8 8 8 8 8 8 8 8 8 8 8 8 8
8 8 8 8 8 8 8 8 8 8 8 8 8 8 8 8 8 8 8 8 8 8
8 8 8 8 8 8 8 8 8 8 8 8 8 8 8 8 8 8 8 8 8 8
8 8 8 8 8 8 8 8 8 8 8 8 8 8 8 8 8 8 8 8 8 8
8 8 8 8 8 8 8 8 8 8 8 8 8 8 8 8 8 8 8 8 8 8
8 8 8 8 8 8 8 8 8 8 8 8 8 8 8 8 8 8 8 8 8 8
8 8 8 8 8 8 8 8 8 8 8 8 8 8 8 8 8 8 8 8 8 8
8 8 8 8 8 8 8 8 8 8 8 8 8 8 8 8 8 8 8 8 8 8
8 8 8 8 8 8 8 8 8 8 8 8 8 8 8 8 8 8 8 8 8 8
8 8 8 8 8 8 8 8 8 8 8 8 8 8 8 8 8 8 8 8 8 8
8 8 8 8 8 8 8 8 8 8 8 8 8 8 8 8 8 8 8 8 8 8
8 8 8 8 8 8 8 8 8 8 8 8 8 8 8 8 8 8 8 8 8 8
8 8 8 8 8 8 8 8 8 8 8 8 8 8 8 8 8 8 8 8 8 9
8 8 8 8 8 8 8 8 8 8 8 8 8 8 8 8 8 9 9 9 9 9
8 8 8 8 8 8 8 8 8 8 8 8 9 9 9 9 9 9 9 9 9 9
8 8 8 8 8 8 8 8 8 8 8 8 9 9 9 9 9 9 9 54 9 9
8 8 8 8 8 8 8 8 8 8 8 8 9 9 9 9 53 64 9 9 9 9
8 8 8 8 8 8 8 8 8 8 8 8 9 9 9 9 54 63 53 64 9 9
8 8 8 8 8 8 8 8 8 8 8 8 9 9 9 64 53 51 52 54 9 9
8 8 8 8 8 8 8 8 8 8 8 8 9 9 9 54 51 98 53 63 9 9
8 8 8 8 8 8 8 8 8 8 8 8 9 9 9 9 54 53 64 9 9 9
8 8 8 8 8 8 8 8 8 8 8 8 9 9 9 63 63 54 63 53 9 9
8 8 8 8 8 8 8 8 8 8 8 8 9 9 9 9 9 51 52 54 9 9
8 8 8 8 8 8 8 8 8 8 8 8 9 9 9 9 9 53 9 9 9 9
8 8 8 8 8 8 8 8 8 8 8 8 9 9 9 54 9 9 9 54 9 9
8 8 8 8 8 8 8 8 8 8 8 8 8 8 8 9 9 9 9 9 9 9
8 8 8 8 8 8 8 8 8 8 8 8 8 8 8 9 9 9 9 9 9 9
8 8 8 8 8 8 8 8 8 8 8 8 8 8 9 9 9 9 9 9 9 9
Level 2
9 9 9 9 9 9 9 9 9 9 9 9 9 9 9 9 9 9 9 9 9 9
9 9 9 9 9 9 9 9 9 9 9 9 9 9 9 9 9 9 9 9 9 9
9 9 9 9 9 9 9 9 9 9 9 9 9 9 9 9 9 9 9 9 9 9
9 9 9 9 9 9 9 9 9 9 9 9 9 9 9 9 9 9 9 9 9 9
9 9 9 9 9 9 9 9 9 9 9 9 9 9 9 9 9 9 9 9 9 9
9 9 9 9 9 9 9 9 9 9 9 9 9 9 9 9 9 9 9 9 9 9
9 9 9 9 9 9 9 9 9 9 9 9 9 9 9 9 9 9 9 9 9 9
9 9 9 9 9 9 9 9 9 9 9 9 9 9 9 9 9 9 9 9 9 9
9 9 9 9 9 9 9 9 9 9 9 9 9 9 9 9 9 9 9 9 9 9
9 9 9 9 9 9 9 9 9 9 9 9 9 9 9 9 9 9 9 9 9 9
9 9 9 9 9 9 9 9 9 9 9 9 9 9 9 9 9 9 9 9 9 9
9 9 9 9 9 9 9 9 9 9 9 9 9 9 9 9 9 9 9 9 9 9
9 9 9 9 9 9 9 9 9 9 9 9 9 9 9 9 9 9 9 9 9 9
9 9 9 9 9 9 9 9 9 9 9 9 9 9 9 9 9 9 9 9 9 9
9 9 9 9 9 9 9 9 9 9 9 9 9 9 9 9 9 9 9 9 9 9
9 9 9 9 9 9 9 9 9 9 9 9 9 9 9 9 9 9 9 9 9 9
9 9 9 9 9 9 9 9 9 9 9 9 9 9 54 9 9 52 9 9 9 .
9 9 9 131 9 9 9 9 9 9 9 9 9 9 9 9 64 9 24 24 133 .
9 54 131 131 131 131 131 9 9 9 9 9 9 54 9 31 21 31 24 130 . .
9 9 131 131 131 131 131 131 54 9 9 9 9 9 51 120 50 50 45 . . .
9 9 131 131 131 131 131 131 9 9 9 9 9 53 64 49 . . 128 . . .
9 9 9 131 131 131 131 131 131 9 9 9 54 9 120 116 . . . . . .
9 9 9 131 131 131 131 131 131 9 9 9 9 30 49 . . . . . . .
9 9 9 9 131 131 131 131 9 9 9 9 9 51 49 . . . . . . .
9 9 9 9 9 131 131 9 9 9 9 9 9 30 123 119 . . . . . .
9 9 9 9 20 9 54 9 9 9 9 9 9 54 21 49 . . . . . .
9 9 9 9 9 9 9 9 9 9 9 9 9 53 61 49 . . . . . .
9 9 9 9 9 9 9 9 9 9 9 9 9 9 24 43 . . . . . .
9 9 9 9 9 9 9 9 9 9 9 9 9 54 24 . . 130 . . . .
9 9 9 9 9 9 9 9 9 9 9 9 9 9 54 . . . . . . .
9 9 9 9 9 9 9 9 9 9 9 9 9 9 9 . . . . . . .
9 9 9 9 9 9 9 9 9 9 9 9 9 9 . . . . . . . .
Level 3
9 9 9 9 9 9 9 9 9 9 9 9 9 9 9 9 9 9 9 9 . .
9 9 9 9 9 9 9 9 9 9 9 9 9 9 9 9 9 9 9 9 . .
9 9 9 9 9 9 9 9 9 9 9 9 9 9 9 9 9 9 9 9 . .
9 9 9 9 9 9 9 9 9 9 9 9 9 9 9 9 9 9 9 9 . .
9 9 9 9 9 9 9 9 9 9 9 9 9 9 9 9 9 9 9 9 . .
9 9 9 9 9 9 9 9 9 9 9 9 9 9 9 9 9 9 9 9 . .
9 9 9 9 9 9 9 9 9 9 9 9 9 9 9 9 9 9 9 9 . .
9 9 9 9 9 9 9 9 9 9 9 9 9 9 9 9 9 9 9 9 . .
9 9 9 9 9 9 9 9 9 9 9 9 9 9 9 9 9 9 9 9 . .
9 9 9 9 9 9 9 9 9 9 9 9 9 9 9 9 9 9 9 9 . .
9 9 9 9 9 9 9 9 9 9 9 9 9 9 9 9 9 9 9 9 . .
9 9 9 9 9 9 9 9 9 9 9 9 9 9 9 9 9 9 9 9 . .
9 . . 9 9 9 9 9 9 9 9 9 9 9 9 9 9 9 9 . . .
. . . . 9 . 9 9 9 9 9 9 9 9 9 9 . 9 . . . .
. . . . . 130 . . 9 9 9 9 9 . 9 . . 10 18 . . .
. . . 10 . 18 . . . . 9 9 . . . 10 18 10 129 . . .
. . 20 128 18 10 18 18 . . . . . 20 . . . . . . . .
. . 130 . . . 130 . 10 130 . . . . . . . . . . . .
. . . . . . . . 18 . . . e1 . . . . . . . . .
. . . . . . . . . . . . . . . . . . . . . .
. 130 . . . . . . . . . . . . . . . . . . . .
. 129 . . . . . . . . 125/texts={"Si quelqu'un lit ce message...","Alors il n'est pas trop tard.","Notre monde s'effondre.","Plus rien ne fait sens.","Ne te perds pas..."} . . . . . . . . . . .
18 . . . . . . . . . . . . . . . . . . . . .
10 . 20 . . . . . . . . . . . . . . . . . . .
. 18 . . . . . . . . 3 . . . . . . . . . . .
. 18 18 . . . . . . . . . . . . . . . . . . .
. . 10 . . . . . . . . . . . . . . . . . . .
. . 130 129 10 128 . . . . p . . . . . . . . . . .
. . . . . 18 130 . . . . . . . . . . . . . . .
. . . . . . . . . . . . . . . . . . . . . .
. . . . . . . . . . . . . . . . . . . . . .
. . . . . . . . . . . . . . . . . . . . . .
Level 4
9 9 9 9 9 9 9 9 9 9 9 9 9 9 9 9 . . . . . .
9 9 9 9 9 9 9 9 9 9 53 9 9 9 9 9 . . . . . .
9 9 9 9 9 9 9 9 9 9 9 21 53 9 9 9 9 . . . . .
9 9 9 9 9 9 9 9 9 9 54 21 21 9 9 9 9 . . . . .
9 9 9 9 9 9 9 9 9 29 9 62 9 53 9 9 9 9 . . . .
9 9 9 9 9 9 9 9 9 52 9 9 9 9 9 9 9 9 . . . .
9 9 9 9 9 9 9 9 9 9 9 9 9 9 9 9 9 . . . . .
9 9 9 9 9 28 9 9 9 29 9 9 9 9 9 9 9 . . . . .
9 9 9 9 9 9 28 28 9 9 9 9 9 9 9 9 . . 129 . . .
9 . 9 9 9 53 9 9 54 9 9 9 9 9 9 . . . . . . .
. 130 . . 9 9 9 53 9 9 9 9 9 9 . . . . 130 . . .
. 128 . . . 9 63 9 9 9 9 9 129 . . . 20 . . . . .
. . . . 129 . . 9 9 . 9 . . . 130 . 129 . . . . .
. . . . . . . . . . . . . . . . . . . . . .
. . . . . . . . . . . . . . . . . . . . . .
. . . . . . . . . . . . . . . . . . . . . .
. . 20 . . . . . . . . . . 20 . . . . . . . .
. . . . . . . . . . . . . . . . . . . . . .
. . . . . . . . . . . . . . . . . . . . . .
. . . . . . . . . . . . . . . . . . . . . .
. . . . . . . . . . . . . . . . . . . . . .
. . . . . . . . . . . . . . . . . . . . . .
. . . . . . . . . . . . . . . . . . . . . .
. . . . . . . . . . . . . . . . . . . . . .
. . . . . . . . . . . . . . . . . . . . . .
. . . . . . . . . . . . . . . . . . . . . .
. . . . . . . . . . . . . . . . . . . . . .
. . . . . . . . . . . . . . . . . . . . . .
. . . . . . . . . . . . . . . . . . . . . .
. . . . . . . . . . . . . . . . . . . . . .
. . . . . . . . . . . . . . . . . . . . . .
. . . . . . . . . . . . . . . . . . . . . .
Level 5
. . . . . . . . . . . . . . . . . . . . . .
. . . . . 27 . . 27 . . . . . . . . . . . . .
. . 26 . . . . . . . . . . . 128 . . . . . . .
. . . . 118 115 115 115 119 129 . 3 . . . . . . . . . .
. 26 . . 114 51 21 21 49 . . . . . 130 . . . . . . .
. 130 . . 114 21 13/world="chapter1/1-2.txt" 21 47 . . . . . . . . 130 . . . .
. . . . 114 21 62 21 49 . . . . . . . . . . . . .
. . 27 . 117 50 48 50 116 . . . . . . . . . . . . .
. 129 . . . . . . . . . . . . . . . . . . . .
. . . . . . . . . . . . . . . . . . . . . .
. . . . . . . . . . . . . . . . . . . . . .
. . . . . . . . . . . . . . . . 20 . . . . .
. . . . . . . . . . . . . . . . . . . . . .
. . . . . . . . . . . . . . . . . . . . . .
. . . . . . . . . . . . . . . . . . . . . .
. . . . . . . . . . . . . . . . . . . . . .
. . 20 . . . . . . . . . . 20 . . . . . . . .
. . . . . . . . . . . . . . . . . . . . . .
. . . . . . . . . . . . . . . . . . . . . .
. . . . . . . . . . . . . . . . . . . . . .
. . . . . . . . . . . . . . . . . . . . . .
. . . . . . . . . . . . . . . . . . . . . .
. . . . . . . . . . . . . . . . . . . . . .
. . . . . . . . . . . . . . . . . . . . . .
. . . . . . . . . . . . . . . . . . . . . .
. . . . . . . . . . . . . . . . . . . . . .
. . . . . . . . . . . . . . . . . . . . . .
. . . . . . . . . . . . . . . . . . . . . .
. . . . . . . . . . . . . . . . . . . . . .
. . . . . . . . . . . . . . . . . . . . . .
. . . . . . . . . . . . . . . . . . . . . .
. . . . . . . . . . . . . . . . . . . . . .
Level 6
. . . . . . . . . . . . . . . . . . . . . .
. . . . . 26 . . . . . . . . . . . . . . . .
. . 27 . . . . . . . . . . . . . . . . . . .
. . . . . . . . . . . . . . . . . . . . . .
. . . . . . . . . . . . . . . . . . . . . .
. . . . . . . . . . . . . . . . . . . . . .
. . . . . . . . . . . . . . . . . . . . . .
. . . . . . . . . . . . . . . . . . . . . .
. . . . . . . . . . . . . . . . . . . . . .
. . . . . . . . . . . . . . . . . . . . . .
. . . . . . . . . . . . . . . . . . . . . .
. . . . . . . . . . . . . . . . 20 . . . . .
. . . . . . . . . . . . . . . . . . . . . .
. . . . . . . . . . . . . . . . . . . . . .
. . . . . . . . . . . . . 18 . . . . . . . .
. 18 18 18 . . . . . . . . 18 18 18 . . . . . . .
. 18 . 18 . . . . . . . 18 18 . 18 18 . . . . . .
. 18 18 18 . . . . . . . . 18 18 18 . . . . . . .
. . . . . . . . . . . . . 18 . . . . . . . .
. . . . . . . . . . . . . . . . . . . . . .
. . . . . . . . . . . . . . . . . . . . . .
. . . . . . . . . . . . . . . . . . . . . .
. . . . . . . . . . . . . . . . . . . . . .
. . . . . . . . . . . . . . . . . . . . . .
. . . . . . . . . . . . . . . . . . . . . .
. . . . . . . . . . . . . . . . . . . . . .
. . . . . . . . . . . . . . . . . . . . . .
. . . . . . . . . . . . . . . . . . . . . .
. . . . . . . . . . . . . . . . . . . . . .
. . . . . . . . . . . . . . . . . . . . . .
. . . . . . . . . . . . . . . . . . . . . .
. . . . . . . . . . . . . . . . . . . . . .
Level 7
. . . . . . . . . . . . . . . . . . . . . .
. . . . . . . . . . . . . . . . . . . . . .
. . . . . . . . . . . . . . . . . . . . . .
. . . . . . . . . . . . . . . . . . . . . .
. . . . . . . . . . . . . . . . . . . . . .
. . . . . . . . . . . . . . . . . . . . . .
. . . . . . . . . . . . . . . . . . . . . .
. . . . . . . . . . . . . . . . . . . . . .
. . . . . . . . . . . . . . . . . . . . . .
. . . . . . . . . . . . . . . . . . . . . .
. . . . . . . . . . . . . . . 18 18 18 . . . .
. . . . . . . . . . . . . . . 18 . 18 . . . .
. . . . . . . . . . . . . . . 18 18 18 . . . .
. . . . . . . . . . . . . . . . . . . . . .
. . . . . . . . . . . . . . . . . . . . . .
. . 18 . . . . . . . . . . 18 . . . . . . . .
. 18 18 18 . . . . . . . . 18 18 18 . . . . . . .
. . 18 . . . . . . . . . . 18 . . . . . . . .
. . . . . . . . . . . . . . . . . . . . . .
. . . . . . . . . . . . . . . . . . . . . .
. . . . . . . . . . . . . . . . . . . . . .
. . . . . . . . . . . . . . . . . . . . . .
. . . . . . . . . . . . . . . . . . . . . .
. . . . . . . . . . . . . . . . . . . . . .
. . . . . . . . . . . . . . . . . . . . . .
. . . . . . . . . . . . . . . . . . . . . .
. . . . . . . . . . . . . . . . . . . . . .
. . . . . . . . . . . . . . . . . . . . . .
. . . . . . . . . . . . . . . . . . . . . .
. . . . . . . . . . . . . . . . . . . . . .
. . . . . . . . . . . . . . . . . . . . . .
. . . . . . . . . . . . . . . . . . . . . .
Level 8
. . . . . . . . . . . . . . . . . . . . . .
. . . . . . . . . . . . . . . . . . . . . .
. . . . . . . . . . . . . . . . . . . . . .
. . . . . . . . . . . . . . . . . . . . . .
. . . . . . . . . . . . . . . . . . . . . .
. . . . . . . . . . . . . . . . . . . . . .
. . . . . . . . . . . . . . . . . . . . . .
. . . . . . . . . . . . . . . . . . . . . .
. . . . . . . . . . . . . . . . . . . . . .
. . . . . . . . . . . . . . . . . . . . . .
. . . . . . . . . . . . . . . . 18 . . . . .
. . . . . . . . . . . . . . . 18 18 18 . . . .
. . . . . . . . . . . . . . . . 18 . . . . .
. . . . . . . . . . . . . . . . . . . . . .
. . . . . . . . . . . . . . . . . . . . . .
. . . . . . . . . . . . . . . . . . . . . .
. . . . . . . . . . . . . . . . . . . . . .
. . . . . . . . . . . . . . . . . . . . . .
. . . . . . . . . . . . . . . . . . . . . .
. . . . . . . . . . . . . . . . . . . . . .
. . . . . . . . . . . . . . . . . . . . . .
. . . . . . . . . . . . . . . . . . . . . .
. . . . . . . . . . . . . . . . . . . . . .
. . . . . . . . . . . . . . . . . . . . . .
. . . . . . . . . . . . . . . . . . . . . .
. . . . . . . . . . . . . . . . . . . . . .
. . . . . . . . . . . . . . . . . . . . . .
. . . . . . . . . . . . . . . . . . . . . .
. . . . . . . . . . . . . . . . . . . . . .
. . . . . . . . . . . . . . . . . . . . . .
. . . . . . . . . . . . . . . . . . . . . .
. . . . . . . . . . . . . . . . . . . . . .
Level 9
6 113 127 . . . . . . . . . . . . . . . . . . .
. . . . . . . . . . . . . . . . . . . . . .
. . . . . . . . . . . . . . . . . . . . . .
. . . . . . . . . . . . . . . . . . . . . .
. . . . . . . . . . . . . . . . . . . . . .
. . . . . . . . . . . . . . . . . . . . . .
. . . . . . . . . . . . . . . . . . . . . .
. . . . . . . . . . . . . . . . . . . . . .
. . . . . . . . . . . . . . . . . . . . . .
. . . . . . . . . . . . . . . . . . . . . .
. . . . . . . . . . . . . . . . . . . . . .
. . . . . . . . . . . . . . . . . . . . . .
. . . . . . . . . . . . . . . . . . . . . .
. . . . . . . . . . . . . . . . . . . . . .
. . . . . . . . . . . . . . . . . . . . . .
. . . . . . . . . . . . . . . . . . . . . .
. . . . . . . . . . . . . . . . . . . . . .
. . . . . . . . . . . . . . . . . . . . . .
. . . . . . . . . . . . . . . . . . . . . .
. . . . . . . . . . . . . . . . . . . . . .
. . . . . . . . . . . . . . . . . . . . . .
. . . . . . . . . . . . . . . . . . . . . .
. . . . . . . . . . . . . . . . . . . . . .
. . . . . . . . . . . . . . . . . . . . . .
. . . . . . . . . . . . . . . . . . . . . .
. . . . . . . . . . . . . . . . . . . . . .
. . . . . . . . . . . . . . . . . . . . . .
. . . . . . . . . . . . . . . . . . . . . .
. . . . . . . . . . . . . . . . . . . . . .
. . . . . . . . . . . . . . . . . . . . . .
. . . . . . . . . . . . . . . . . . . . . .
. . . . . . . . . . . . . . . . . . . . . .
