20 30 10
Level 0
8 8 8 8 8 8 8 8 8 8 8 8 8 8 8 8 8 8 8 8
8 8 8 8 8 8 8 8 8 8 8 8 8 8 8 8 8 8 8 8
8 8 8 8 8 8 8 8 8 8 8 8 8 8 8 8 8 8 8 8
8 8 8 8 8 8 8 8 8 8 8 8 8 8 8 8 8 8 8 8
8 8 8 8 8 8 8 8 8 8 8 8 8 8 8 8 8 8 8 8
8 8 8 8 8 8 8 8 8 8 8 8 8 8 8 8 8 8 8 8
8 8 8 8 8 8 8 8 8 8 8 8 8 8 8 8 8 8 8 8
8 8 8 8 8 8 8 8 8 8 8 8 8 8 8 8 8 8 8 8
8 8 8 8 8 8 8 8 8 8 8 8 8 8 8 8 8 8 8 8
8 8 8 8 8 8 8 8 8 8 8 8 8 8 8 8 8 8 8 8
8 8 8 8 8 8 8 8 8 8 8 8 8 8 8 8 8 8 8 8
8 8 8 8 8 8 8 8 8 8 8 8 8 8 8 8 8 8 8 8
8 8 8 8 8 8 8 8 8 8 8 8 8 8 8 8 8 8 8 8
8 8 8 8 8 8 8 8 8 8 8 8 8 8 8 8 8 8 8 8
8 8 8 8 8 8 8 8 8 8 8 8 8 8 8 8 8 8 8 8
8 8 8 8 8 8 8 8 8 8 8 8 8 8 8 8 8 8 8 8
8 8 8 8 8 8 8 8 8 8 8 8 8 8 8 8 8 8 8 8
8 8 8 8 8 8 8 8 8 8 8 8 8 8 8 8 8 8 8 8
8 8 8 8 8 8 8 8 8 8 8 8 8 8 8 8 8 8 8 8
8 8 8 8 8 8 8 8 8 8 8 8 8 8 8 8 8 8 8 8
8 8 8 8 8 8 8 8 8 8 8 8 8 8 8 8 8 8 8 8
8 8 8 8 8 8 8 8 8 8 8 8 8 8 8 8 8 8 8 8
8 8 8 8 8 8 8 8 8 8 8 8 8 8 8 8 8 8 8 8
8 8 8 8 8 8 8 8 8 8 8 8 8 8 8 8 8 8 8 8
8 8 8 8 8 8 8 8 8 8 8 8 8 8 8 8 8 8 8 8
8 8 8 8 8 8 8 8 8 8 8 8 8 8 8 8 8 8 8 8
8 8 8 8 8 8 8 8 8 8 8 8 8 8 8 8 8 8 8 8
8 8 8 8 8 8 8 8 8 8 8 8 8 8 8 8 8 8 8 8
8 8 8 8 8 8 8 8 8 8 8 8 8 8 8 8 8 8 8 8
8 8 8 8 8 8 8 8 8 8 8 8 8 8 8 8 8 8 8 8
Level 1
8 8 8 8 8 8 8 8 8 8 8 8 8 8 8 8 8 8 8 8
8 8 8 8 8 8 8 8 8 8 8 8 8 8 8 8 8 8 8 8
8 8 8 8 8 8 8 8 8 8 8 8 8 8 8 8 8 8 8 8
8 8 8 8 8 8 8 8 8 8 8 8 8 8 8 8 8 8 8 8
8 8 8 8 8 8 8 8 8 8 8 8 8 8 8 8 8 8 8 8
8 8 8 8 8 8 8 8 8 8 8 8 8 8 8 8 8 8 8 8
8 8 8 8 8 8 8 8 8 8 8 8 8 8 8 8 8 8 8 8
8 8 8 8 8 8 8 8 8 8 8 8 8 8 8 8 8 8 8 8
8 8 8 8 8 8 8 8 8 8 8 8 8 8 8 8 8 8 8 8
8 8 8 8 8 8 8 8 8 8 8 8 8 8 8 8 8 8 8 8
8 8 8 8 8 8 8 8 8 8 8 8 8 8 8 8 8 8 8 8
8 8 8 8 8 8 8 8 8 8 8 8 8 8 8 8 8 8 8 8
8 8 8 8 8 8 8 8 8 8 8 8 8 8 8 8 8 8 8 8
8 8 8 8 8 8 8 8 8 8 8 8 8 8 8 8 8 8 8 8
8 8 8 8 8 8 8 8 8 8 8 8 8 8 8 8 8 8 8 8
8 8 8 8 8 8 8 8 8 8 8 8 8 8 8 8 8 8 8 8
8 8 8 8 8 8 8 8 8 8 8 8 8 8 8 8 8 8 8 8
8 8 8 8 8 8 8 8 8 8 8 8 8 8 8 8 8 9 9 9
8 8 8 8 8 8 8 8 8 8 8 8 9 9 9 9 9 9 9 9
8 8 8 8 8 8 8 8 8 8 8 8 9 9 9 9 9 9 9 54
8 8 8 8 8 8 8 8 8 8 8 8 9 9 9 9 53 64 9 9
8 8 8 8 8 8 8 8 8 8 8 8 9 9 9 9 54 63 53 64
8 8 8 8 8 8 8 8 8 8 8 8 9 9 9 64 53 51 52 54
8 8 8 8 8 8 8 8 8 8 8 8 9 9 9 54 51 98/network=1/activated=false 53 63
8 8 8 8 8 8 8 8 8 8 8 8 9 9 9 9 54 53 64 9
8 8 8 8 8 8 8 8 8 8 8 8 9 9 9 63 63 54 63 53
8 8 8 8 8 8 8 8 8 8 8 8 9 9 9 9 9 51 52 54
8 8 8 8 8 8 8 8 8 8 8 8 9 9 9 9 9 53 9 9
8 8 8 8 8 8 8 8 8 8 8 8 9 9 9 54 9 9 9 54
8 8 8 8 8 8 8 8 8 8 8 8 8 8 8 9 9 9 9 9
Level 2
9 9 9 9 9 9 9 9 9 9 9 9 9 9 9 9 9 9 9 8
9 9 9 9 9 9 9 9 9 9 9 9 9 9 9 9 9 9 9 8
9 9 9 9 9 9 9 9 9 9 9 9 9 9 9 9 9 9 9 8
9 9 9 9 9 9 9 9 9 9 9 9 9 9 9 9 9 9 9 8
9 9 9 9 9 9 9 9 9 9 9 9 9 9 9 9 9 9 9 8
9 9 9 9 9 9 9 9 9 9 9 9 9 9 9 9 9 9 9 8
9 9 9 9 9 9 9 9 9 9 9 9 9 9 9 9 9 9 9 8
9 9 9 9 9 9 9 9 9 9 9 9 9 9 9 9 9 9 9 8
9 9 9 9 9 9 9 9 9 9 9 9 9 9 9 9 9 9 9 8
9 9 9 9 9 9 9 9 9 9 9 9 9 9 9 9 9 9 9 8
9 9 9 9 9 9 9 9 9 9 9 9 9 9 9 9 9 9 9 8
9 9 9 9 9 9 9 9 9 9 9 9 9 9 9 9 9 9 9 8
9 9 9 9 9 9 9 9 9 9 9 9 9 9 9 9 9 9 9 9
9 9 9 9 9 9 9 9 9 9 9 9 9 9 9 9 9 9 9 9
9 9 9 9 9 9 9 9 9 9 9 9 9 9 9 9 9 9 9 9
9 9 9 9 9 9 9 9 9 9 9 9 9 9 9 9 9 9 9 9
9 9 9 9 9 9 9 9 9 9 9 9 9 9 54 9 9 52 9 9
9 9 9 . 9 9 9 9 9 9 9 9 9 9 9 9 64 9 24 24
9 54 . 107 . . . 9 9 9 9 9 9 54 9 31 21 31 24 .
9 9 . 107 107 107 107 . 54 9 9 9 9 9 51 120 50 50 45 .
9 9 . 107 107 107 107 . 9 9 9 9 9 53 64 49 . . . .
9 9 9 . 107 107 107 107 . 9 9 9 54 9 120 116 . . . .
9 9 9 . 107 107 107 . . 9 9 9 9 30 49 . . . . .
9 9 9 9 . 107 . . 9 9 9 9 9 51 49 . . . . .
9 9 9 9 9 . . 9 9 9 9 9 9 30 123 119 . . . .
9 9 9 9 20 9 54 9 9 9 9 9 9 54 21 49 . . . .
9 9 9 9 9 9 9 9 9 9 9 9 9 53 61 49 . . . .
9 9 9 9 9 9 9 9 9 9 9 9 9 9 24 43 . . . .
9 9 9 9 9 9 9 9 9 9 9 9 9 54 24 . . . . .
9 9 9 9 9 9 9 9 9 9 9 9 9 9 54 . . . . .
Level 3
9 9 9 9 9 9 9 9 9 9 9 9 9 9 9 9 9 9 9 9
9 9 9 9 9 9 9 9 9 9 9 9 9 9 9 9 9 9 9 9
9 9 9 9 9 9 9 9 9 9 9 9 9 9 9 9 9 9 9 9
9 9 9 9 9 9 9 9 9 9 9 9 9 9 9 9 9 9 9 9
9 9 9 9 9 9 9 9 9 9 9 9 9 9 9 9 9 9 9 9
9 9 9 9 9 9 9 9 9 9 9 9 9 9 9 9 9 9 9 9
9 9 9 9 9 9 9 9 9 9 9 9 9 9 9 9 9 9 9 9
9 9 9 9 9 9 9 9 9 9 9 9 9 9 9 9 9 9 9 9
9 9 9 9 9 9 9 9 9 9 9 9 9 9 9 9 9 9 9 9
9 9 9 9 9 9 9 9 9 9 9 9 9 9 9 9 9 9 9 9
9 9 9 9 9 9 9 9 9 9 9 9 9 9 9 9 9 9 9 9
9 9 9 9 9 9 9 9 9 9 9 9 9 9 9 9 9 9 9 9
9 . . 9 9 9 9 9 9 9 9 9 9 9 9 9 9 9 9 .
. . . . 9 . 9 9 9 9 9 9 9 9 9 9 . 9 . .
. . . . . . . . 9 9 9 9 9 . 9 . . 10 18 .
. . . 10 . 18 . . . . 9 9 . . . 10 18 10 . .
. . 20 . 18 10 18 18 . . . . . 20 . . . . . .
. . . . . . . . 10 . . . . . . . . . . .
. . . . . . . . 18 . . . e1 . . . . . . .
. . . . . . . . . . . . . . . . . . . .
. . . . . . . . . . . . . . . . . . . .
. . . . . . . . . . 125/texts={Si_quelqu'un_lit_ce_message...,Alors_il_n'est_pas_trop_tard.,Notre_monde_s'effondre.,Plus_rien_ne_fait_sens.,Ne_te_perds_pas...} . . . . . . . . .
18 . . . . . . . . . . . . . . . . . . .
10 . 20 . . . . . . . . . . . . . . . . .
. 18 . . . . . . . . 3 . . . . . . . . .
. 18 18 . . . . . . . . . . . . . . . . .
. . 10 . . . . . . . . . . . . . . . . .
. . . . 10 . . . . . p . . . . . . . . .
. . . . . 18 . . . . . . . . . . . . . .
. . . . . . . . . . . . . . . . . . . .
Level 4
9 9 9 9 9 9 9 9 9 9 9 9 9 9 9 9 . . . .
9 9 9 9 9 9 9 9 9 9 53 9 9 9 9 9 . . . .
9 9 9 9 9 9 9 9 9 9 9 21 53 9 9 9 9 . . .
9 9 9 9 9 9 9 9 9 9 54 21 21 9 9 9 9 . . .
9 9 9 9 9 9 9 9 9 29 9 62 9 53 9 9 9 9 . .
9 9 9 9 9 9 9 9 9 52 9 9 9 9 9 9 9 9 . .
9 9 9 9 9 9 9 9 9 9 9 9 9 9 9 9 9 . . .
9 9 9 9 9 28 9 9 9 29 9 9 9 9 9 9 9 . . .
9 9 9 9 9 9 28 28 9 9 9 9 9 9 9 9 . . . .
9 . 9 9 9 53 9 9 54 9 9 9 9 9 9 . . . . .
. . . . 9 9 9 53 9 9 9 9 9 9 . . . . . .
. . . . . 9 63 9 9 9 9 9 . . . . 20 . . .
. . . . . . . 9 9 . 9 . . . . . . . . .
. . . . . . . . . . . . . . . . . . . .
. . . . . . . . . . . . . . . . . . . .
. . . . . . . . . . . . . . . . . . . .
. . 20 . . . . . . . . . . 20 . . . . . .
. . . . . . . . . . . . . . . . . . . .
. . . . . . . . . . . . . . . . . . . .
. . . . . . . . . . . . . . . . . . . .
. . . . . . . . . . . . . . . . . . . .
. . . . . . . . . . . . . . . . . . . .
. . . . . . . . . . . . . . . . . . . .
. . . . . . . . . . . . . . . . . . . .
. . . . . . . . . . . . . . . . . . . .
. . . . . . . . . . . . . . . . . . . .
. . . . . . . . . . . . . . . . . . . .
. . . . . . . . . . . . . . . . . . . .
. . . . . . . . . . . . . . . . . . . .
. . . . . . . . . . . . . . . . . . . .
Level 5
. . . . . . . . . . . . . . . . . . . .
. . . . . 27 . . 27 . . . . . . . . . . .
. . 26 . . . . . . . . . . . . . . . . .
. . . . 118 115 115 115 119 . . 3 . . . . . . . .
. 26 . . 114 51 21 21 49 . . . . . . . . . . .
. . . . 114 21 13/network=1/activated=false 21 47 . . . . . . . . . . .
. . . . 114 21 62 21 49 . . . . . . . . . . .
. . 27 . 117 50 48 50 116 . . . . . . . . . . .
. . . . . . . . . . . . . . . . . . . .
. . . . . . . . . . . . . . . . . . . .
. . . . . . . . . . . . . . . . . . . .
. . . . . . . . . . . . . . . . 20 . . .
. . . . . . . . . . . . . . . . . . . .
. . . . . . . . . . . . . . . . . . . .
. . . . . . . . . . . . . . . . . . . .
. . . . . . . . . . . . . . . . . . . .
. . 20 . . . . . . . . . . 20 . . . . . .
. . . . . . . . . . . . . . . . . . . .
. . . . . . . . . . . . . . . . . . . .
. . . . . . . . . . . . . . . . . . . .
. . . . . . . . . . . . . . . . . . . .
. . . . . . . . . . . . . . . . . . . .
. . . . . . . . . . . . . . . . . . . .
. . . . . . . . . . . . . . . . . . . .
. . . . . . . . . . . . . . . . . . . .
. . . . . . . . . . . . . . . . . . . .
. . . . . . . . . . . . . . . . . . . .
. . . . . . . . . . . . . . . . . . . .
. . . . . . . . . . . . . . . . . . . .
. . . . . . . . . . . . . . . . . . . .
Level 6
. . . . . . . . . . . . . . . . . . . .
. . . . . 26 . . . . . . . . . . . . . .
. . 27 . . . . . . . . . . . . . . . . .
. . . . . . . . . . . . . . . . . . . .
. . . . . . . . . . . . . . . . . . . .
. . . . . . . . . . . . . . . . . . . .
. . . . . . . . . . . . . . . . . . . .
. . . . . . . . . . . . . . . . . . . .
. . . . . . . . . . . . . . . . . . . .
. . . . . . . . . . . . . . . . . . . .
. . . . . . . . . . . . . . . . . . . .
. . . . . . . . . . . . . . . . 20 . . .
. . . . . . . . . . . . . . . . . . . .
. . . . . . . . . . . . . . . . . . . .
. . . . . . . . . . . . . 18 . . . . . .
. 18 18 18 . . . . . . . . 18 18 18 . . . . .
. 18 . 18 . . . . . . . 18 18 . 18 18 . . . .
. 18 18 18 . . . . . . . . 18 18 18 . . . . .
. . . . . . . . . . . . . 18 . . . . . .
. . . . . . . . . . . . . . . . . . . .
. . . . . . . . . . . . . . . . . . . .
. . . . . . . . . . . . . . . . . . . .
. . . . . . . . . . . . . . . . . . . .
. . . . . . . . . . . . . . . . . . . .
. . . . . . . . . . . . . . . . . . . .
. . . . . . . . . . . . . . . . . . . .
. . . . . . . . . . . . . . . . . . . .
. . . . . . . . . . . . . . . . . . . .
. . . . . . . . . . . . . . . . . . . .
. . . . . . . . . . . . . . . . . . . .
Level 7
. . . . . . . . . . . . . . . . . . . .
. . . . . . . . . . . . . . . . . . . .
. . . . . . . . . . . . . . . . . . . .
. . . . . . . . . . . . . . . . . . . .
. . . . . . . . . . . . . . . . . . . .
. . . . . . . . . . . . . . . . . . . .
. . . . . . . . . . . . . . . . . . . .
. . . . . . . . . . . . . . . . . . . .
. . . . . . . . . . . . . . . . . . . .
. . . . . . . . . . . . . . . . . . . .
. . . . . . . . . . . . . . . 18 18 18 . .
. . . . . . . . . . . . . . . 18 . 18 . .
. . . . . . . . . . . . . . . 18 18 18 . .
. . . . . . . . . . . . . . . . . . . .
. . . . . . . . . . . . . . . . . . . .
. . 18 . . . . . . . . . . 18 . . . . . .
. 18 18 18 . . . . . . . . 18 18 18 . . . . .
. . 18 . . . . . . . . . . 18 . . . . . .
. . . . . . . . . . . . . . . . . . . .
. . . . . . . . . . . . . . . . . . . .
. . . . . . . . . . . . . . . . . . . .
. . . . . . . . . . . . . . . . . . . .
. . . . . . . . . . . . . . . . . . . .
. . . . . . . . . . . . . . . . . . . .
. . . . . . . . . . . . . . . . . . . .
. . . . . . . . . . . . . . . . . . . .
. . . . . . . . . . . . . . . . . . . .
. . . . . . . . . . . . . . . . . . . .
. . . . . . . . . . . . . . . . . . . .
. . . . . . . . . . . . . . . . . . . .
Level 8
. . . . . . . . . . . . . . . . . . . .
. . . . . . . . . . . . . . . . . . . .
. . . . . . . . . . . . . . . . . . . .
. . . . . . . . . . . . . . . . . . . .
. . . . . . . . . . . . . . . . . . . .
. . . . . . . . . . . . . . . . . . . .
. . . . . . . . . . . . . . . . . . . .
. . . . . . . . . . . . . . . . . . . .
. . . . . . . . . . . . . . . . . . . .
. . . . . . . . . . . . . . . . . . . .
. . . . . . . . . . . . . . . . 18 . . .
. . . . . . . . . . . . . . . 18 18 18 . .
. . . . . . . . . . . . . . . . 18 . . .
. . . . . . . . . . . . . . . . . . . .
. . . . . . . . . . . . . . . . . . . .
. . . . . . . . . . . . . . . . . . . .
. . . . . . . . . . . . . . . . . . . .
. . . . . . . . . . . . . . . . . . . .
. . . . . . . . . . . . . . . . . . . .
. . . . . . . . . . . . . . . . . . . .
. . . . . . . . . . . . . . . . . . . .
. . . . . . . . . . . . . . . . . . . .
. . . . . . . . . . . . . . . . . . . .
. . . . . . . . . . . . . . . . . . . .
. . . . . . . . . . . . . . . . . . . .
. . . . . . . . . . . . . . . . . . . .
. . . . . . . . . . . . . . . . . . . .
. . . . . . . . . . . . . . . . . . . .
. . . . . . . . . . . . . . . . . . . .
. . . . . . . . . . . . . . . . . . . .
Level 9
6 113 . . . . . . . . . . . . . . . . . .
. . . . . . . . . . . . . . . . . . . .
. . . . . . . . . . . . . . . . . . . .
. . . . . . . . . . . . . . . . . . . .
. . . . . . . . . . . . . . . . . . . .
. . . . . . . . . . . . . . . . . . . .
. . . . . . . . . . . . . . . . . . . .
. . . . . . . . . . . . . . . . . . . .
. . . . . . . . . . . . . . . . . . . .
. . . . . . . . . . . . . . . . . . . .
. . . . . . . . . . . . . . . . . . . .
. . . . . . . . . . . . . . . . . . . .
. . . . . . . . . . . . . . . . . . . .
. . . . . . . . . . . . . . . . . . . .
. . . . . . . . . . . . . . . . . . . .
. . . . . . . . . . . . . . . . . . . .
. . . . . . . . . . . . . . . . . . . .
. . . . . . . . . . . . . . . . . . . .
. . . . . . . . . . . . . . . . . . . .
. . . . . . . . . . . . . . . . . . . .
. . . . . . . . . . . . . . . . . . . .
. . . . . . . . . . . . . . . . . . . .
. . . . . . . . . . . . . . . . . . . .
. . . . . . . . . . . . . . . . . . . .
. . . . . . . . . . . . . . . . . . . .
. . . . . . . . . . . . . . . . . . . .
. . . . . . . . . . . . . . . . . . . .
. . . . . . . . . . . . . . . . . . . .
. . . . . . . . . . . . . . . . . . . .
. . . . . . . . . . . . . . . . . . . .
