10 20 7
Level 0
9 9 9 9 9 9 9 9 9 9
9 9 9 9 9 9 9 9 9 9
9 9 9 9 9 9 9 9 9 9
9 9 9 9 9 9 9 9 9 9
9 9 9 9 9 9 9 9 9 9
9 9 9 9 9 9 9 9 9 9
9 9 9 9 9 9 9 9 9 9
9 9 9 9 9 9 9 9 9 9
9 9 9 9 9 9 9 9 9 9
9 9 9 9 9 9 9 9 9 9
9 9 9 9 9 9 9 9 9 9
9 9 9 9 9 9 9 9 9 9
9 9 9 9 9 9 9 9 9 9
9 9 9 9 9 9 9 9 9 9
9 9 9 9 9 9 9 9 9 9
9 9 9 9 9 9 9 9 9 9
9 9 9 9 9 9 9 9 9 9
9 9 9 9 9 9 9 9 9 9
9 9 9 9 9 9 9 9 9 9
9 9 9 9 9 9 9 9 9 9
Level 1
9 9 9 9 9 9 9 9 9 9
9 9 9 9 9 9 9 9 9 9
9 9 9 9 9 9 9 9 9 9
9 9 9 9 9 9 9 9 9 9
9 9 9 9 9 9 9 9 9 9
9 9 9 9 9 9 9 9 9 9
9 9 9 9 9 9 9 9 9 9
9 9 9 9 9 9 9 9 9 9
9 9 9 9 9 9 9 9 9 9
9 9 9 9 9 9 9 9 9 9
9 9 9 9 9 9 9 9 9 9
9 9 9 . . . 9 9 9 9
9 9 . . . . 9 9 9 9
9 . . . . . 9 9 9 9
. . . . . . . 9 9 9
. . . . . . . 9 9 9
. . . . . . . 9 9 9
. . . . . . . 9 9 9
. . . . . . . . 9 9
. . . . . . . . 9 9
Level 2
9 9 9 9 9 9 9 9 9 9
9 9 9 9 9 9 9 9 9 9
9 9 9 9 9 9 9 9 9 9
9 9 9 9 9 9 9 9 9 9
9 9 9 9 9 9 9 9 9 9
9 9 9 9 9 9 9 9 9 9
9 9 9 9 9 9 9 9 9 9
9 9 9 9 9 9 9 9 9 9
9 9 9 . . . 9 9 9 9
9 . . . . . . 9 9 9
. . . . . . . 9 9 9
. . . . . . . 9 9 9
. . . . . . . 9 9 9
. . . . . . . 9 98/network=0 9
. . . . . . . . 9 9
. . . . . . . . 9 9
. . . . . . . . 9 9
. . . . . . . . . .
. . . . . . . . . .
. . . . . . . . . .
Level 3
107 107 107 107 107 107 107 107 107 107
107 107 107 107 107 107 107 107 107 107
107 11 107 107 107 107 107 107 107 107
107 107 107 107 107 107 107 107 107 107
107 107 107 107 107 107 107 107 107 107
107 107 107 107 107 107 107 107 107 107
25 25 25 25 25 25 25 25 25 25
. . . . 162/network=1/radius=4 . . . . .
. . . . . . e1 . . .
. . . . . . . . . .
. e1 . . . . . . . .
. . . . . . . . . .
. . . . . . . . . .
. . . . . . . p . .
. . . . . . . . . .
. . . . . . . . . .
. . . . . . . . . .
. . . . . . . . . .
. . . . . . . . . .
. . . . . . . . . .
Level 4
107 107 107 107 107 107 107 107 107 107
107 107 107 107 107 107 107 107 107 107
107 107 107 107 107 107 107 107 107 107
107 107 107 107 107 107 107 107 107 107
107 107 107 107 107 107 107 107 107 107
107 107 107 107 107 107 107 107 107 107
25 25 25 25 25 25 25 25 25 25
. . . . . . . . . .
. . . . . . . . . .
. . . . . . . . . .
. . . . . . . . . .
. . . . . . . . . .
. . . . . . . . . .
. . . . . . . . . .
. . . . . . . . . .
. . . . . . . . . .
. . . . . . . . . .
. . . . . . . . . .
. . . . . . . . . .
. . . . . . . . . .
Level 5
107 107 107 107 107 107 107 107 107 107
107 107 107 107 107 107 107 107 107 107
107 107 107 107 107 107 107 107 107 107
107 107 107 107 107 107 107 107 107 107
107 107 107 107 107 107 107 107 107 107
107 107 107 107 107 107 107 107 107 107
25 25 25 25 25 25 25 25 25 25
. . . . . . . . . .
. . . . . . . . . .
. . . . . . . . . .
. . . . . . . . . .
. . . . . . . . . .
. . . . . . . . . .
. . . . . . . . . .
. . . . . . . . . .
. . . . . . . . . .
. . . . . . . . . .
. . . . . . . . . .
. . . . . . . . . .
. . . . . . . . . .
Level 6
. . . . . . . . . .
. . . . . . . . . .
. . . . . . . . . .
. . . . . . . . . .
. . . . . . . . . .
. . . . . . . . . .
. . . . . . . . . .
. . . . . . . . . .
. . . . . . . . . .
. . . . . . . . . .
. . . . . . . . . .
. . . . . . . . . .
. . . . . . . . . .
. 6 . . . . . . . .
. . . . . . . . . .
. . . . . . . . . .
. . . . . . . . . .
. . . . . . . . . .
. . . . . . . . . .
111/delay=25/networkExit=1/network=0 . . . . . . . . .
