10 10 7
Level 0
8 8 8 8 8 8 8 8 8 8
8 8 8 8 8 8 8 8 8 8
8 8 8 8 8 8 8 8 8 8
8 8 8 8 8 8 8 8 8 8
8 8 8 8 8 8 8 8 8 8
8 8 8 8 8 8 8 8 8 8
8 8 8 8 8 8 8 8 8 8
8 8 8 8 8 8 8 8 8 8
8 53/activated=true 8 8 8 8 8 8 8 8
8 8 8 8 8 8 8 8 8 8
Level 1
20 20 20 20 20 20 20 20 20 20
20 20 20 . . . 20 20 20 20
. . . . . e1 . . . .
. . . . . . . . . .
. . . . . . . . . .
. . . . . . . . . .
. . . . p . . . . .
. . . . . . . . . .
. . . . . . . . . .
. . . . . . . . . .
Level 2
20 20 20 20 20 20 20 20 20 20
20 20 20 20 20 20 20 20 20 20
. . . . . e1 . . . .
. . . . . . . . . .
. . . . . . . . . .
. . . . . . . . . .
. . . . . . . . . .
. . . . . . . . . .
. . . . . . . . . .
. . . . . . . . . .
Level 3
20 20 20 20 20 20 20 20 20 20
20 20 20 20 20 20 20 20 20 20
. . . . . e1 . . . .
. . . . . . . . . .
. . . . . . . . . .
. . . . . . . . . .
. . . . . . . . . .
. . . . . . . . . .
. . . . . . . . . .
. . . . . . . . . .
Level 4
20 20 20 20 20 20 20 20 20 20
20 20 20 20 20 20 20 20 20 20
. . . . . e1 . . . .
. . . . . . . . . .
. . . . . . . . . .
. . . . . . . . . .
. . . . . . . . . .
. . . . . . . . . .
. . . . . . . . . .
. . . . . . . . . .
Level 5
20 20 20 20 20 20 20 20 20 20
20 20 20 20 20 20 20 20 20 20
. . . . . e1 . . . .
. . . . . . . . . .
. . . . . . . . . .
. . . . . . . . . .
. . . . . . . . . .
. . . . . . . . . .
. . . . . . . . . .
. . . . . . . . . .
Level 6
20 20 20 20 20 20 20 20 20 20
20 53/activated=true 20 20 20 20 20 20 20 20
. . . . . e1 . . . .
. . . . . . . . . .
. . . . . . . . . .
. . . . . . . . . .
. . . . . . . . . .
. . . . . . . . . .
. . . . . . . . 5 .
. . . . . . . . . .
