10 20 7
Level 0
8 8 8 8 8 8 8 8 8 8
8 8 8 8 8 8 8 8 8 8
8 8 8 8 8 8 8 8 8 8
8 8 8 8 8 8 8 8 8 8
8 8 8 8 8 8 8 8 8 8
8 8 8 8 8 8 8 8 8 8
8 8 8 8 8 8 8 8 8 8
8 8 8 8 8 8 8 8 8 8
8 8 8 8 8 8 8 8 8 8
8 8 8 8 8 8 8 8 8 8
8 8 8 8 8 8 8 8 8 8
8 8 8 8 8 8 8 8 8 8
8 8 8 8 8 8 8 8 8 8
8 8 8 8 8 8 8 8 8 8
8 8 8 8 8 8 8 8 8 8
8 8 8 8 8 8 8 8 8 8
8 8 8 8 8 8 8 8 8 8
8 8 8 8 8 8 8 8 8 8
8 8 8 8 8 8 8 8 8 8
8 8 8 8 8 8 8 8 8 8
Level 1
8 8 8 8 8 8 8 8 8 8
8 8 8 8 8 8 8 8 8 8
8 8 8 8 8 8 8 8 8 8
8 8 8 8 8 8 8 8 8 8
8 8 8 8 8 8 8 8 8 8
8 8 8 8 8 8 8 8 8 8
8 8 8 8 8 8 8 8 8 8
8 8 8 8 8 8 8 8 8 8
8 8 8 8 8 8 8 8 8 8
8 8 8 8 8 8 8 8 8 8
8 8 8 8 8 8 8 8 8 8
8 8 8 . . . 8 8 8 8
8 8 . . . . 8 8 8 8
8 . . . . . 8 8 8 8
. . . . . . . 8 8 8
. . . . . . . 8 8 8
. . . . . . . 8 8 8
. . . . . . . 8 8 8
. . . . . . . . 8 8
. . . . . . . . 8 8
Level 2
8 8 8 8 8 8 8 8 8 8
8 8 8 8 8 8 8 8 8 8
8 8 8 8 8 8 8 8 8 8
8 8 8 8 8 8 8 8 8 8
8 8 8 8 8 8 8 8 8 8
8 8 8 8 8 8 8 8 8 8
8 8 8 8 8 8 8 8 8 8
8 8 8 8 8 8 8 8 8 8
8 8 8 . . . 8 8 8 8
8 . . . . . . 8 8 8
. . . . . . . 8 8 8
. . . . . . . 8 8 8
. . . . . . . 8 8 8
. . . . . . . 8 83/network=0 8
. . . . . . . . 8 8
. . . . . . . . 8 8
. . . . . . . . 8 8
. . . . . . . . . .
. . . . . . . . . .
. . . . . . . . . .
Level 3
92 92 92 92 92 92 92 92 92 92
92 92 92 92 92 92 92 92 92 92
92 10 92 92 92 92 92 92 92 92
92 92 92 92 92 92 92 92 92 92
92 92 92 92 92 92 92 92 92 92
92 92 92 92 92 92 92 92 92 92
24 24 24 24 24 24 24 24 24 24
. . . . 118/network=1/radius=4 . . . . .
. . . . . . e1 . . .
. . . . . . . . . .
. e1 . . . . . . . .
. . . . . . . . . .
. . . . . . . . . .
. . . . . . . p . .
. . . . . . . . . .
. . . . . . . . . .
. . . . . . . . . .
. . . . . . . . . .
. . . . . . . . . .
. . . . . . . . . .
Level 4
92 92 92 92 92 92 92 92 92 92
92 92 92 92 92 92 92 92 92 92
92 92 92 92 92 92 92 92 92 92
92 92 92 92 92 92 92 92 92 92
92 92 92 92 92 92 92 92 92 92
92 92 92 92 92 92 92 92 92 92
24 24 24 24 24 24 24 24 24 24
. . . . . . . . . .
. . . . . . . . . .
. . . . . . . . . .
. . . . . . . . . .
. . . . . . . . . .
. . . . . . . . . .
. . . . . . . . . .
. . . . . . . . . .
. . . . . . . . . .
. . . . . . . . . .
. . . . . . . . . .
. . . . . . . . . .
. . . . . . . . . .
Level 5
92 92 92 92 92 92 92 92 92 92
92 92 92 92 92 92 92 92 92 92
92 92 92 92 92 92 92 92 92 92
92 92 92 92 92 92 92 92 92 92
92 92 92 92 92 92 92 92 92 92
92 92 92 92 92 92 92 92 92 92
24 24 24 24 24 24 24 24 24 24
. . . . . . . . . .
. . . . . . . . . .
. . . . . . . . . .
. . . . . . . . . .
. . . . . . . . . .
. . . . . . . . . .
. . . . . . . . . .
. . . . . . . . . .
. . . . . . . . . .
. . . . . . . . . .
. . . . . . . . . .
. . . . . . . . . .
. . . . . . . . . .
Level 6
. . . . . . . . . .
. . . . . . . . . .
. . . . . . . . . .
. . . . . . . . . .
. . . . . . . . . .
. . . . . . . . . .
. . . . . . . . . .
. . . . . . . . . .
. . . . . . . . . .
. . . . . . . . . .
. . . . . . . . . .
. . . . . . . . . .
. . . . . . . . . .
. 5 . . . . . . . .
. . . . . . . . . .
. . . . . . . . . .
. . . . . . . . . .
. . . . . . . . . .
. . . . . . . . . .
96/delay=25/networkExit=1/network=0 . . . . . . . . .
