20 20 15
Level 0
8 8 8 8 8 8 8 8 8 8 8 8 8 8 8 8 8 8 8 8
8 8 8 8 8 8 8 8 8 8 8 8 8 8 8 8 8 8 8 8
8 8 8 8 8 8 8 8 8 8 8 8 8 8 8 8 8 8 8 8
8 8 8 8 8 8 8 8 8 8 8 8 8 8 8 8 8 8 8 8
8 8 8 8 8 8 8 8 8 8 8 8 8 8 8 8 8 8 8 8
8 8 8 8 8 8 8 8 8 8 8 8 8 8 8 8 8 8 8 8
8 8 8 8 8 8 8 8 8 8 8 8 8 8 8 8 8 8 8 8
8 8 8 8 8 8 8 8 8 8 8 8 8 8 8 8 8 8 8 8
8 8 8 8 8 8 8 8 8 8 8 8 8 8 8 8 8 8 8 8
8 8 8 8 8 8 8 8 8 8 8 8 8 8 8 8 8 8 8 8
8 8 8 8 8 8 8 8 8 8 8 8 8 8 8 8 8 8 8 8
8 8 8 8 8 8 8 8 8 8 8 8 8 8 8 8 8 8 8 8
8 8 8 8 8 8 8 8 8 8 8 8 8 8 8 8 8 8 8 8
8 8 8 8 8 8 8 8 8 8 8 8 8 8 8 8 8 8 8 8
8 8 8 8 8 8 8 8 8 8 8 8 8 8 8 8 8 8 8 8
8 8 8 8 8 8 8 8 8 8 8 8 8 8 8 8 8 8 8 8
8 8 8 8 8 8 8 8 8 8 8 8 8 8 8 8 8 8 8 8
8 8 8 8 8 8 8 8 8 8 8 8 8 8 8 8 8 8 8 8
8 8 8 8 8 8 8 8 8 8 8 8 8 8 8 8 8 8 8 8
8 8 8 8 8 8 8 8 8 8 8 8 8 8 8 8 8 8 8 8
Level 1
8 8 8 8 8 8 8 8 8 8 8 8 8 8 8 8 . . . .
8 8 8 8 8 8 8 8 8 8 8 8 8 8 8 8 . . . .
8 8 8 8 8 8 8 8 8 8 8 8 8 8 8 8 . . . .
8 8 8 8 8 8 8 8 8 8 8 8 8 8 8 8 . . . .
8 8 8 8 8 8 8 8 8 8 8 8 8 8 8 8 . . . .
8 8 8 8 8 8 8 8 8 8 8 8 8 8 8 8 . . . .
8 8 8 8 8 8 8 8 8 8 8 8 8 8 8 8 . . . .
8 8 8 8 8 8 8 8 8 8 8 8 8 8 8 8 . . . .
8 8 8 8 8 8 8 8 8 8 8 8 8 8 8 8 . . . .
8 8 8 8 8 8 8 8 8 8 8 8 8 8 8 8 . . p .
8 8 8 8 8 8 8 8 8 8 8 8 8 8 8 8 . . . .
8 8 8 8 8 8 8 8 8 8 8 8 8 8 8 8 . . . .
8 8 8 8 8 8 8 8 8 8 8 8 8 8 8 8 . . . .
8 8 8 8 8 8 8 8 8 8 8 8 8 8 8 8 . . . .
8 8 8 8 8 8 8 8 8 8 8 8 8 8 8 8 . . . .
8 8 8 8 8 8 8 8 8 8 8 8 8 8 8 8 . . . .
8 8 8 8 8 8 8 8 8 8 8 8 8 8 8 8 . . . .
8 8 8 8 8 8 8 8 8 8 8 8 8 8 8 8 . . . .
8 8 8 8 8 8 8 8 8 8 8 8 8 8 8 8 . . . .
8 8 8 8 8 8 8 8 8 8 8 8 8 8 8 8 . . . .
Level 2
8 8 8 8 8 8 8 8 8 8 8 8 8 8 . . . . . .
8 8 8 8 8 8 8 8 8 8 8 8 8 8 8 . . . . .
8 8 8 8 8 8 8 8 8 8 8 8 8 8 8 8 . . . .
8 8 8 8 8 8 8 8 8 8 8 8 8 8 8 8 . . . .
8 8 8 8 8 8 8 8 8 8 8 8 8 8 8 8 . . . .
8 8 8 8 8 8 8 8 8 8 8 8 8 8 8 . . . . .
8 8 8 8 8 8 8 8 8 8 8 8 8 8 8 . . . . .
8 8 8 8 8 8 8 8 8 8 8 8 8 8 . . . . . .
8 8 8 8 8 8 8 8 8 8 . . . . . . . . . .
8 8 8 8 8 8 8 8 . . . . . . . . . . . .
8 8 8 8 8 8 8 8 . . . . . . . . . . . .
8 8 8 8 8 8 8 8 8 8 . . . . . . . . . .
8 8 8 8 8 8 8 8 8 8 8 . . . . . . . . .
8 8 8 8 8 8 8 8 8 8 8 . . . . . . . . .
8 8 8 8 8 8 8 8 8 8 8 . . . . . . . . .
8 8 8 8 8 8 8 8 8 8 8 . . . . . . . . .
8 8 8 8 8 8 8 8 8 8 . . . . . . . . . .
8 8 8 8 8 8 8 8 8 8 . . . . . . . . . .
8 8 8 8 8 8 8 8 8 8 . . . . . . . . . .
8 8 8 8 8 8 8 8 8 8 . . . . . . . . . .
Level 3
20 20 20 20 20 20 20 20 20 20 20 . . . . . . . . .
20 20 20 20 20 20 20 20 20 20 20 . . . . . . . . .
20 20 20 20 20 20 20 20 20 20 20 . . . . . . . . .
20 20 20 20 20 20 20 20 20 20 20 . . . . . . . . .
20 20 20 20 20 20 20 20 20 20 20 . . . . . . . . .
20 20 20 20 20 20 20 20 20 20 20 . . . . . . . . .
92 92 92 92 20 . . . . . . . . . . . . . . .
92 92 92 92 20 . . . . . . . . . . . . . . .
92 92 92 92 20 . . . . . . . . . . . . . . .
92 92 92 92 20 . . . . . . . . . . . . . . .
92 92 92 92 20 . . . . . . . . . . . . . . .
92 92 92 92 20 . . . . . . . . . . . . . . .
92 92 92 92 20 . . . . . . . . . . . . . . .
20 20 20 20 20 20 20 . . . . . . . . . . . . .
92 92 92 92 92 92 20 . . . . . . . . . . . . .
92 92 92 92 92 92 20 . . . . . . . . . . . . .
92 92 92 92 92 92 20 . . . . . . . . . . . . .
92 92 92 92 92 92 20 . . . . . . . . . . . . .
92 92 92 92 92 92 20 . . . . . . . . . . . . .
92 92 92 92 92 92 20 . . . . . . . . . . . . .
Level 4
92 92 92 92 92 . . . . . 20 . . . . . . . . .
92 92 92 92 92 . . . . . 20 . . . . . . . . .
92 92 92 92 92 . . . . . 20 . . . . . . . . .
92 92 92 92 92 . . . . . . . . . . . . . . .
92 92 92 92 92 . . . . . 20 . . . . . . . . .
20 20 20 20 20 20 20 20 20 20 20 . . . . . . . . .
92 92 92 92 20 . . . . . . . . . . . . . . .
92 92 92 92 20 . . . . . . . . . . . . . . .
92 92 92 92 20 . . . . . . . . . . . . . . .
92 92 92 92 . . . . . . . . . . . . . . . .
92 92 92 92 20 . . . . . . . . . . . . . . .
92 92 92 92 20 . . . . . . . . . . . . . . .
92 92 92 92 20 . . . . . . . . . . . . . . .
20 20 20 20 20 20 20 . . . . . . . . . . . . .
92 92 92 92 92 92 20 . . . . . . . . . . . . .
92 92 92 92 92 92 20 . . . . . . . . . . . . .
92 92 92 92 92 92 20 . . . . . . . . . . . . .
92 92 92 92 92 92 20 . . . . . . . . . . . . .
92 92 92 92 92 92 20 . . . . . . . . . . . . .
92 92 92 92 92 92 20 . . . . . . . . . . . . .
Level 5
. . . . . . . . . . . . . . . . . . . .
. . . . . . . . . . . . . . . . . . . .
. . . . . . . . . . . . . . . . . . . .
. . . . . . . . . . . . . . . . . . . .
. . . . . . . . . . . . . . . . . . . .
. . . . . . . . . . . . . . . . . . . .
. . . . . . . . . . . . . . . . . . . .
. . . . . . . . . . . . . . . . . . . .
. . . . . . . . 5 . . . . . . . . . . .
. . . e4 . . . . . . . . . . . . . . . .
. . . . . . . . . . . . . . . . . . . .
. . . . . . . . . . . . . . . . . . . .
. . . . . . . . . . . . . . . . . . . .
20 20 20 20 20 20 20 . . . . . . . . . . . . .
92 92 92 92 92 92 20 . . . . . . . . . . . . .
92 92 92 92 92 92 20 . . . . . . . . . . . . .
92 92 92 92 92 92 . . . . . . . . . . . . . .
92 92 92 92 92 92 20 . . . . . . . . . . . . .
92 92 92 92 92 92 20 . . . . . . . . . . . . .
92 92 92 92 92 92 20 . . . . . . . . . . . . .
Level 6
. . . . . . . . . . . . . . . . . . . .
. . . . . . . . . . . . . . . . . . . .
. . . . . . . . . . . . . . . . . . . .
. . . . . . . . . . . . . . . . . . . .
. . . . . . . . . . . . . . . . . . . .
. . . . . . . . . . . . . . . . . . . .
. . . . . . . . . . . . . . . . . . . .
. . . . . . . . . . . . . . . . . . . .
. . . . . . . . . . . . . . . . . . . .
. . . . . . . . . . . . . . . . . . . .
. . . . . . . . . . . . . . . . . . . .
. . . . . . . . . . . . . . . . . . . .
. . . . . . . . . . . . . . . . . . . .
20 20 20 20 20 20 20 . . . . . . . . . . . . .
92 92 92 92 92 92 20 . . . . . . . . . . . . .
92 92 92 92 92 92 20 . . . . . . . . . . . . .
92 92 92 92 92 92 20 . . . . . . . . . . . . .
92 92 92 92 92 92 20 . . . . . . . . . . . . .
92 92 92 92 92 92 20 . . . . . . . . . . . . .
92 92 92 92 92 92 20 . . . . . . . . . . . . .
Level 7
. . . . . . . . . . . . . . . . . . . .
. . . . . . . . . . . . . . . . . . . .
. . . . . . . . . . . . . . . . . . . .
. . . . . . . . . . . . . . . . . . . .
. . . . . . . . . . . . . . . . . . . .
. . . . . . . . . . . . . . . . . . . .
. . . . . . . . . . . . . . . . . . . .
. . . . . . . . . . . . . . . . . . . .
. . . . . . . . . . . . . . . . . . . .
. . . . . . . . . . . . . . . . . . . .
. . . . . . . . . . . . . . . . . . . .
. . . . . . . . . . . . . . . . . . . .
. . . . . . . . . . . . . . . . . . . .
. . . . . . . . . . . . . . . . . . . .
. . . . . . . . . . . . . . . . . . . .
. . . . . . . . . . . . . . . . . . . .
. . . . . . . . . . . . . . . . . . . .
. . . . . . . . . . . . . . . . . . . .
. . . . . . . . . . . . . . . . . . . .
. . . . . . . . . . . . . . . . . . . .
Level 8
. . . . . . . . . . . . . . . . . . . .
. . . . . . . . . . . . . . . . . . . .
. . . . . . . . . . . . . . . . . . . .
. . . . . . . . . . . . . . . . . . . .
. . . . . . . . . . . . . . . . . . . .
. . . . . . . . . . . . . . . . . . . .
. . . . . . . . . . . . . . . . . . . .
. . . . . . . . . . . . . . . . . . . .
. . . . . . . . . . . . . . . . . . . .
. . . . . . . . . . . . . . . . . . . .
. . . . . . . . . . . . . . . . . . . .
. . . . . . . . . . . . . . . . . . . .
. . . . . . . . . . . . . . . . . . . .
. . . . . . . . . . . . . . . . . . . .
. . . . . . . . . . . . . . . . . . . .
. . . . . . . . . . . . . . . . . . . .
. . . . . . . . . . . . . . . . . . . .
. . . . . . . . . . . . . . . . . . . .
. . . . . . . . . . . . . . . . . . . .
. . . . . . . . . . . . . . . . . . . .
Level 9
. . . . . . . . . . . . . . . . . . . .
. . . . . . . . . . . . . . . . . . . .
. . . . . . . . . . . . . . . . . . . .
. . . . . . . . . . . . . . . . . . . .
. . . . . . . . . . . . . . . . . . . .
. . . . . . . . . . . . . . . . . . . .
. . . . . . . . . . . . . . . . . . . .
. . . . . . . . . . . . . . . . . . . .
. . . . . . . . . . . . . . . . . . . .
. . . . . . . . . . . . . . . . . . . .
. . . . . . . . . . . . . . . . . . . .
. . . . . . . . . . . . . . . . . . . .
. . . . . . . . . . . . . . . . . . . .
. . . . . . . . . . . . . . . . . . . .
. . . . . . . . . . . . . . . . . . . .
. . . . . . . . . . . . . . . . . . . .
. . . . . . . . . . . . . . . . . . . .
. . . . . . . . . . . . . . . . . . . .
. . . . . . . . . . . . . . . . . . . .
. . . . . . . . . . . . . . . . . . . .
Level 10
. . . . . . . . . . . . . . . . . . . .
. . . . . . . . . . . . . . . . . . . .
. . . . . . . . . . . . . . . . . . . .
. . . . . . . . . . . . . . . . . . . .
. . . . . . . . . . . . . . . . . . . .
. . . . . . . . . . . . . . . . . . . .
. . . . . . . . . . . . . . . . . . . .
. . . . . . . . . . . . . . . . . . . .
. . . . . . . . . . . . . . . . . . . .
. . . . . . . . . . . . . . . . . . . .
. . . . . . . . . . . . . . . . . . . .
. . . . . . . . . . . . . . . . . . . .
. . . . . . . . . . . . . . . . . . . .
. . . . . . . . . . . . . . . . . . . .
. . . . . . . . . . . . . . . . . . . .
. . . . . . . . . . . . . . . . . . . .
. . . . . . . . . . . . . . . . . . . .
. . . . . . . . . . . . . . . . . . . .
. . . . . . . . . . . . . . . . . . . .
. . . . . . . . . . . . . . . . . . . .
Level 11
. . . . . . . . . . . . . . . . . . . .
. . . . . . . . . . . . . . . . . . . .
. . . . . . . . . . . . . . . . . . . .
. . . . . . . . . . . . . . . . . . . .
. . . . . . . . . . . . . . . . . . . .
. . . . . . . . . . . . . . . . . . . .
. . . . . . . . . . . . . . . . . . . .
. . . . . . . . . . . . . . . . . . . .
. . . . . . . . . . . . . . . . . . . .
. . . . . . . . . . . . . . . . . . . .
. . . . . . . . . . . . . . . . . . . .
. . . . . . . . . . . . . . . . . . . .
. . . . . . . . . . . . . . . . . . . .
. . . . . . . . . . . . . . . . . . . .
. . . . . . . . . . . . . . . . . . . .
. . . . . . . . . . . . . . . . . . . .
. . . . . . . . . . . . . . . . . . . .
. . . . . . . . . . . . . . . . . . . .
. . . . . . . . . . . . . . . . . . . .
. . . . . . . . . . . . . . . . . . . .
Level 12
. . . . . . . . . . . . . . . . . . . .
. . . . . . . . . . . . . . . . . . . .
. . . . . . . . . . . . . . . . . . . .
. . . . . . . . . . . . . . . . . . . .
. . . . . . . . . . . . . . . . . . . .
. . . . . . . . . . . . . . . . . . . .
. . . . . . . . . . . . . . . . . . . .
. . . . . . . . . . . . . . . . . . . .
. . . . . . . . . . . . . . . . . . . .
. . . . . . . . . . . . . . . . . . . .
. . . . . . . . . . . . . . . . . . . .
. . . . . . . . . . . . . . . . . . . .
. . . . . . . . . . . . . . . . . . . .
. . . . . . . . . . . . . . . . . . . .
. . . . . . . . . . . . . . . . . . . .
. . . . . . . . . . . . . . . . . . . .
. . . . . . . . . . . . . . . . . . . .
. . . . . . . . . . . . . . . . . . . .
. . . . . . . . . . . . . . . . . . . .
. . . . . . . . . . . . . . . . . . . .
Level 13
. . . . . . . . . . . . . . . . . . . .
. . . . . . . . . . . . . . . . . . . .
. . . . . . . . . . . . . . . . . . . .
. . . . . . . . . . . . . . . . . . . .
. . . . . . . . . . . . . . . . . . . .
. . . . . . . . . . . . . . . . . . . .
. . . . . . . . . . . . . . . . . . . .
. . . . . . . . . . . . . . . . . . . .
. . . . . . . . . . . . . . . . . . . .
. . . . . . . . . . . . . . . . . . . .
. . . . . . . . . . . . . . . . . . . .
. . . . . . . . . . . . . . . . . . . .
. . . . . . . . . . . . . . . . . . . .
. . . . . . . . . . . . . . . . . . . .
. . . . . . . . . . . . . . . . . . . .
. . . . . . . . . . . . . . . . . . . .
. . . . . . . . . . . . . . . . . . . .
. . . . . . . . . . . . . . . . . . . .
. . . . . . . . . . . . . . . . . . . .
. . . . . . . . . . . . . . . . . . . .
Level 14
. . . . . . . . . . . . . . . . . . . .
. . . . . . . . . . . . . . . . . . . .
. . . . . . . . . . . . . . . . . . . .
. . . . . . . . . . . . . . . . . . . .
. . . . . . . . . . . . . . . . . . . .
. . . . . . . . . . . . . . . . . . . .
. . . . . . . . . . . . . . . . . . . .
. . . . . . . . . . . . . . . . . . . .
. . . . . . . . . . . . . . . . . . . .
. . . . . . . . . . . . . . . . . . . .
. . . . . . . . . . . . . . . . . . . .
. . . . . . . . . . . . . . . . . . . .
. . . . . . . . . . . . . . . . . . . .
. . . . . . . . . . . . . . . . . . . .
. . . . . . . . . . . . . . . . . . . .
. . . . . . . . . . . . . . . . . . . .
. . . . . . . . . . . . . . . . . . . .
. . . . . . . . . . . . . . . . . . . .
. . . . . . . . . . . . . . . . . . . .
. . . . . . . . . . . . . . . . . . . .
