10 10 7
Level 0
9 9 9 9 9 9 9 9 9 9
9 9 9 9 9 9 9 9 9 9
9 9 9 9 9 9 9 9 9 9
9 9 9 9 9 9 9 9 9 9
9 9 9 9 9 9 9 9 9 9
9 9 9 9 9 9 9 9 9 9
9 9 9 9 9 9 9 9 9 9
9 9 9 9 9 9 9 9 9 9
9 68/activated=true 9 9 9 9 9 9 9 9
9 9 9 9 9 9 9 9 9 9
Level 1
21 21 21 21 21 21 21 21 21 21
21 21 21 . . . 21 21 21 21
. . . . . e1 . . . .
. . . . . . . . . .
. . . . . . . . . .
. . . . . . . . . .
. . . . p . . . . .
. . . . . . . . . .
. . . . . . . . . .
. . . . . . . . . .
Level 2
21 21 21 21 21 21 21 21 21 21
21 21 21 21 21 21 21 21 21 21
. . . . . e1 . . . .
. . . . . . . . . .
. . . . . . . . . .
. . . . . . . . . .
. . . . . . . . . .
. . . . . . . . . .
. . . . . . . . . .
. . . . . . . . . .
Level 3
21 21 21 21 21 21 21 21 21 21
21 21 21 21 21 21 21 21 21 21
. . . . . e1 . . . .
. . . . . . . . . .
. . . . . . . . . .
. . . . . . . . . .
. . . . . . . . . .
. . . . . . . . . .
. . . . . . . . . .
. . . . . . . . . .
Level 4
21 21 21 21 21 21 21 21 21 21
21 21 21 21 21 21 21 21 21 21
. . . . . e1 . . . .
. . . . . . . . . .
. . . . . . . . . .
. . . . . . . . . .
. . . . . . . . . .
. . . . . . . . . .
. . . . . . . . . .
. . . . . . . . . .
Level 5
21 21 21 21 21 21 21 21 21 21
21 21 21 21 21 21 21 21 21 21
. . . . . e1 . . . .
. . . . . . . . . .
. . . . . . . . . .
. . . . . . . . . .
. . . . . . . . . .
. . . . . . . . . .
. . . . . . . . . .
. . . . . . . . . .
Level 6
21 21 21 21 21 21 21 21 21 21
21 68/activated=true 21 21 21 21 21 21 21 21
. . . . . e1 . . . .
. . . . . . . . . .
. . . . . . . . . .
. . . . . . . . . .
. . . . . . . . . .
. . . . . . . . . .
. . . . . . . . 6 .
. . . . . . . . . .
