10 20 5
Level 0
9 9 9 9 9 9 9 9 9 9
9 9 53 53 9 9 9 9 9 9
9 52 53 53 9 9 9 9 9 9
9 111/delay=75/networkExit=2/network=0 52 52 9 9 9 9 9 9
9 111/delay=25/networkExit=1/network=0 51 52 52 9 9 9 9 9
9 52 51 52 52 9 9 9 9 9
9 51 51 52 52 9 9 9 9 9
9 9 52 52 9 9 9 9 9 9
9 9 9 9 9 9 9 9 9 9
9 9 9 9 9 9 9 9 9 9
9 9 9 98/network=0 9 9 9 9 9 9
9 9 9 9 9 9 9 9 9 9
9 9 9 9 9 9 9 9 9 9
9 9 9 9 9 9 9 9 9 9
9 9 9 9 9 9 9 9 9 9
9 9 9 9 9 9 9 9 9 9
9 9 9 9 9 9 9 9 9 9
9 9 9 9 9 9 9 9 9 9
9 9 9 9 9 9 9 9 9 9
9 9 9 9 9 9 9 9 9 9
Level 1
. . . . . . . . . .
. . . . 130 . . . 25 .
. 21 21 25 25 . 162/network=1/radius=3 . 25 130
. 21 . . . . . . . .
. 21 162/network=2/radius=5 . . 25 128 . . .
. 25 . . . 25 . . . .
. 25 . . . 25 . . . .
128 . . . . 25 . . . .
. . . . . . . 130 . .
. . . . . . . . . .
. . . . . . . . . .
. . 130 . . . . . . .
. . . . . . . . . .
. . . . . . . 130 . .
. . . . 128 p . . . .
. . . . . . . . . .
. . . . . . . . . .
. . 130 . . . 130 . . .
128 . . . . . . . . .
. . . . . . . . . .
Level 2
. . . . . . . . . .
. . . . . . . . 25 .
. 21 25 25 . . . . . .
. 21 . . . . . . . .
. 25 . . . . . . . .
. 25 . . . 25 . . . .
. . . . . 25 . . . .
. . . . . 25 . . . .
. . . . . . . . . .
. . . . . . . . . .
. . . . . . . . . .
. . . . . . . . . .
. . . . . . . . . .
. . . . . . . . . .
. . . . . . . . . .
. . . . . . . . . .
. . . . . . . . . .
. . . . . . . . . .
. . . . . . . . . .
. . . . . . . . . .
Level 3
. . . . . . . . . .
. . . . . . . . . .
. 25 25 25 . . . . . .
. 25 . . . . . . . .
. 25 . . . . . . . .
. . . . . . . . . .
. . . . . . . . . .
. . . . . . . . . .
. . . . . . . . . .
. . . . . . . . . .
. . . . . . . . . .
. . . . . . . . . .
. . . . . . . . . .
. . . . . . . . . .
. . . . . . . . . .
. . . . . . . . . .
. . . . . . . . . .
. . . . . . . . . .
. . . . . . . . . .
. . . . . . . . . .
Level 4
. . . . . . . . . .
. . . . . . . . . .
. . . . . . . . . .
. . . . . . . . . .
. . . . . . . . . .
. . . . . . . . . .
. . . . . . . . . .
. . . . . . . . . .
. . . . . . . . . .
. . . . . . . . . .
. . . . . . . . . .
. . . . . . . . . .
. . . . . . . . . .
. . . 6 . . . . . .
. . . . . . . . . .
. . . . . . . . . .
. . . . . . . . . .
. . . . . . . . . .
. . . . . . . . . .
. . . . . . . . . .
