10 20 5
Level 0
8 8 8 8 8 8 8 8 8 8
8 8 38 38 8 8 8 8 8 8
8 37 38 38 8 8 8 8 8 8
8 96/delay=75/networkExit=2/network=0 37 37 8 8 8 8 8 8
8 96/delay=25/networkExit=1/network=0 36 37 37 8 8 8 8 8
8 37 36 37 37 8 8 8 8 8
8 36 36 37 37 8 8 8 8 8
8 8 37 37 8 8 8 8 8 8
8 8 8 8 8 8 8 8 8 8
8 8 8 8 8 8 8 8 8 8
8 8 8 83/network=0 8 8 8 8 8 8
8 8 8 8 8 8 8 8 8 8
8 8 8 8 8 8 8 8 8 8
8 8 8 8 8 8 8 8 8 8
8 8 8 8 8 8 8 8 8 8
8 8 8 8 8 8 8 8 8 8
8 8 8 8 8 8 8 8 8 8
8 8 8 8 8 8 8 8 8 8
8 8 8 8 8 8 8 8 8 8
8 8 8 8 8 8 8 8 8 8
Level 1
. . . . . . . . . .
. . . . 102 . . . 24 .
. 20 20 24 24 . 118/network=1/radius=3 . 24 102
. 20 . . . . . . . .
. 20 118/network=2/radius=5 . . 24 100 . . .
. 24 . . . 24 . . . .
. 24 . . . 24 . . . .
100 . . . . 24 . . . .
. . . . . . . 102 . .
. . . . . . . . . .
. . . . . . . . . .
. . 102 . . . . . . .
. . . . . . . . . .
. . . . . . . 102 . .
. . . . 100 p . . . .
. . . . . . . . . .
. . . . . . . . . .
. . 102 . . . 102 . . .
100 . . . . . . . . .
. . . . . . . . . .
Level 2
. . . . . . . . . .
. . . . . . . . 24 .
. 20 24 24 . . . . . .
. 20 . . . . . . . .
. 24 . . . . . . . .
. 24 . . . 24 . . . .
. . . . . 24 . . . .
. . . . . 24 . . . .
. . . . . . . . . .
. . . . . . . . . .
. . . . . . . . . .
. . . . . . . . . .
. . . . . . . . . .
. . . . . . . . . .
. . . . . . . . . .
. . . . . . . . . .
. . . . . . . . . .
. . . . . . . . . .
. . . . . . . . . .
. . . . . . . . . .
Level 3
. . . . . . . . . .
. . . . . . . . . .
. 24 24 24 . . . . . .
. 24 . . . . . . . .
. 24 . . . . . . . .
. . . . . . . . . .
. . . . . . . . . .
. . . . . . . . . .
. . . . . . . . . .
. . . . . . . . . .
. . . . . . . . . .
. . . . . . . . . .
. . . . . . . . . .
. . . . . . . . . .
. . . . . . . . . .
. . . . . . . . . .
. . . . . . . . . .
. . . . . . . . . .
. . . . . . . . . .
. . . . . . . . . .
Level 4
. . . . . . . . . .
. . . . . . . . . .
. . . . . . . . . .
. . . . . . . . . .
. . . . . . . . . .
. . . . . . . . . .
. . . . . . . . . .
. . . . . . . . . .
. . . . . . . . . .
. . . . . . . . . .
. . . . . . . . . .
. . . . . . . . . .
. . . . . . . . . .
. . . 5 . . . . . .
. . . . . . . . . .
. . . . . . . . . .
. . . . . . . . . .
. . . . . . . . . .
. . . . . . . . . .
. . . . . . . . . .
