10 20 7
Level 0
50 50 50 50 50 50 50 50 50 50
50 50 50 50 50 50 50 50 50 50
50 50 50 50 50 50 50 50 50 50
50 50 50 50 50 50 50 50 50 50
50 50 50 50 50 50 50 50 50 50
50 50 50 50 50 50 50 50 50 50
50 50 50 50 50 50 50 50 50 50
50 50 50 50 50 50 50 50 50 50
50 50 50 50 50 50 50 50 50 50
50 50 50 50 50 50 50 50 50 50
50 50 50 50 50 50 50 50 50 50
50 50 50 50 50 50 50 50 50 50
50 50 50 50 50 50 50 50 50 50
50 50 50 50 50 50 50 50 50 50
50 50 50 50 50 50 50 50 50 50
50 50 50 50 50 50 50 50 50 50
50 50 50 50 50 50 50 50 50 50
50 50 50 50 50 50 50 50 50 50
50 50 50 50 50 50 50 50 50 50
50 50 50 50 50 50 50 50 50 50
Level 1
50 50 50 50 50 50 50 50 50 50
50 50 50 50 50 50 50 50 50 50
50 50 50 50 50 50 50 50 50 50
50 50 50 50 50 50 50 50 50 50
50 50 50 50 50 50 50 50 50 50
50 50 50 50 50 50 50 50 50 50
50 50 50 50 50 50 50 50 50 50
50 50 50 50 50 50 50 50 50 50
50 50 50 50 50 50 50 50 50 50
50 50 50 50 50 50 50 50 50 50
50 50 50 50 50 50 50 50 50 50
50 50 50 . . . 50 50 50 50
50 50 . . . . 50 50 50 50
50 . . . . . 50 50 50 50
. . . . . . . 50 50 50
. . . . . . . 50 50 50
. . . . . . . 50 50 50
. . . . . . . 50 50 50
. . . . . . . . 50 50
. . . . . . . . 50 50
Level 2
50 50 50 50 50 50 50 50 50 50
50 50 50 50 50 50 50 50 50 50
50 50 50 50 50 50 50 50 50 50
50 50 50 50 50 50 50 50 50 50
50 50 50 50 50 50 50 50 50 50
50 50 50 50 50 50 50 50 50 50
50 50 50 50 50 50 50 50 50 50
50 50 50 50 50 50 50 50 50 50
50 50 50 . . . 50 50 50 50
50 . . . . . . 50 50 50
. . . . . . . 50 50 50
. . . . . . . 50 50 50
. . . . . . . 50 50 50
. . . . . . . 50 100/network=0 50
. . . . . . . . 50 50
. . . . . . . . 50 50
. . . . . . . . 50 50
. . . . . . . . . .
. . . . . . . . . .
. . . . . . . . . .
Level 3
67 67 67 67 67 67 67 67 67 67
67 67 67 67 67 67 67 67 67 67
67 98 67 67 67 67 67 67 67 67
67 67 67 67 67 67 67 67 67 67
67 67 67 67 67 67 67 67 67 67
67 67 67 67 67 67 67 67 67 67
19 19 19 19 19 19 19 19 19 19
. . . . 102/network=1/radius=4 . . . . .
. . . . . . e1 . . .
. . . . . . . . . .
. e1 . . . . . . . .
. . . . . . . . . .
. . . . . . . . . .
. . . . . . . p . .
. . . . . . . . . .
. . . . . . . . . .
. . . . . . . . . .
. . . . . . . . . .
. . . . . . . . . .
. . . . . . . . . .
Level 4
67 67 67 67 67 67 67 67 67 67
67 67 67 67 67 67 67 67 67 67
67 67 67 67 67 67 67 67 67 67
67 67 67 67 67 67 67 67 67 67
67 67 67 67 67 67 67 67 67 67
67 67 67 67 67 67 67 67 67 67
19 19 19 19 19 19 19 19 19 19
. . . . . . . . . .
. . . . . . . . . .
. . . . . . . . . .
. . . . . . . . . .
. . . . . . . . . .
. . . . . . . . . .
. . . . . . . . . .
. . . . . . . . . .
. . . . . . . . . .
. . . . . . . . . .
. . . . . . . . . .
. . . . . . . . . .
. . . . . . . . . .
Level 5
67 67 67 67 67 67 67 67 67 67
67 67 67 67 67 67 67 67 67 67
67 67 67 67 67 67 67 67 67 67
67 67 67 67 67 67 67 67 67 67
67 67 67 67 67 67 67 67 67 67
67 67 67 67 67 67 67 67 67 67
19 19 19 19 19 19 19 19 19 19
. . . . . . . . . .
. . . . . . . . . .
. . . . . . . . . .
. . . . . . . . . .
. . . . . . . . . .
. . . . . . . . . .
. . . . . . . . . .
. . . . . . . . . .
. . . . . . . . . .
. . . . . . . . . .
. . . . . . . . . .
. . . . . . . . . .
. . . . . . . . . .
Level 6
. . . . . . . . . .
. . . . . . . . . .
. . . . . . . . . .
. . . . . . . . . .
. . . . . . . . . .
. . . . . . . . . .
. . . . . . . . . .
. . . . . . . . . .
. . . . . . . . . .
. . . . . . . . . .
. . . . . . . . . .
. . . . . . . . . .
. . . . . . . . . .
. 127 . . . . . . . .
. . . . . . . . . .
. . . . . . . . . .
. . . . . . . . . .
. . . . . . . . . .
. . . . . . . . . .
109/delay=25/networkExit=1/network=0 . . . . . . . . .
