5 5 3
Level 0
0 1 2 0 1
1 2 0 1 2
2 0 0 0 1
0 1 0 0 .
1 2 1 . .
Level 1
1 10 . . .
. p . . .
. . p . .
. 3 . . .
. . . . .
Level 2
. . . . .
. . . . .
. . . . .
. . . . .
. . . . .