20 20 15
Level 0
9 9 9 9 9 9 9 9 9 9 9 9 9 9 9 9 9 9 9 9
9 9 9 9 9 9 9 9 9 9 9 9 9 9 9 9 9 9 9 9
9 9 9 9 9 9 9 9 9 9 9 9 9 9 9 9 9 9 9 9
9 9 9 9 9 9 9 9 9 9 9 9 9 9 9 9 9 9 9 9
9 9 9 9 9 9 9 9 9 9 9 9 9 9 9 9 9 9 9 9
9 9 9 9 9 9 9 9 9 9 9 9 9 9 9 9 9 9 9 9
9 9 9 9 9 9 9 9 9 9 9 9 9 9 9 9 9 9 9 9
9 9 9 9 9 9 9 9 9 9 9 9 9 9 9 9 9 9 9 9
9 9 9 9 9 9 9 9 9 9 9 9 9 9 9 9 9 9 9 9
9 9 9 9 9 9 9 9 9 9 9 9 9 9 9 9 9 9 9 9
9 9 9 9 9 9 9 9 9 9 9 9 9 9 9 9 9 9 9 9
9 9 9 9 9 9 9 9 9 9 9 9 9 9 9 9 9 9 9 9
9 9 9 9 9 9 9 9 9 9 9 9 9 9 9 9 9 9 9 9
9 9 9 9 9 9 9 9 9 9 9 9 9 9 9 9 9 9 9 9
9 9 9 9 9 9 9 9 9 9 9 9 9 9 9 9 9 9 9 9
9 9 9 9 9 9 9 9 9 9 9 9 9 9 9 9 9 9 9 9
9 9 9 9 9 9 9 9 9 9 9 9 9 9 9 9 9 9 9 9
9 9 9 9 9 9 9 9 9 9 9 9 9 9 9 9 9 9 9 9
9 9 9 9 9 9 9 9 9 9 9 9 9 9 9 9 9 9 9 9
9 9 9 9 9 9 9 9 9 9 9 9 9 9 9 9 9 9 9 9
Level 1
9 9 9 9 9 9 9 9 9 9 9 9 9 9 9 9 . . . .
9 9 9 9 9 9 9 9 9 9 9 9 9 9 9 9 . . . .
9 9 9 9 9 9 9 9 9 9 9 9 9 9 9 9 . . . .
9 9 9 9 9 9 9 9 9 9 9 9 9 9 9 9 . . . .
9 9 9 9 9 9 9 9 9 9 9 9 9 9 9 9 . . . .
9 9 9 9 9 9 9 9 9 9 9 9 9 9 9 9 . . . .
9 9 9 9 9 9 9 9 9 9 9 9 9 9 9 9 . . . .
9 9 9 9 9 9 9 9 9 9 9 9 9 9 9 9 . . . .
9 9 9 9 9 9 9 9 9 9 9 9 9 9 9 9 . . . .
9 9 9 9 9 9 9 9 9 9 9 9 9 9 9 9 . . p .
9 9 9 9 9 9 9 9 9 9 9 9 9 9 9 9 . . . .
9 9 9 9 9 9 9 9 9 9 9 9 9 9 9 9 . . . .
9 9 9 9 9 9 9 9 9 9 9 9 9 9 9 9 . . . .
9 9 9 9 9 9 9 9 9 9 9 9 9 9 9 9 . . . .
9 9 9 9 9 9 9 9 9 9 9 9 9 9 9 9 . . . .
9 9 9 9 9 9 9 9 9 9 9 9 9 9 9 9 . . . .
9 9 9 9 9 9 9 9 9 9 9 9 9 9 9 9 . . . .
9 9 9 9 9 9 9 9 9 9 9 9 9 9 9 9 . . . .
9 9 9 9 9 9 9 9 9 9 9 9 9 9 9 9 . . . .
9 9 9 9 9 9 9 9 9 9 9 9 9 9 9 9 . . . .
Level 2
9 9 9 9 9 9 9 9 9 9 9 9 9 9 . . . . . .
9 9 9 9 9 9 9 9 9 9 9 9 9 9 9 . . . . .
9 9 9 9 9 9 9 9 9 9 9 9 9 9 9 9 . . . .
9 9 9 9 9 9 9 9 9 9 9 9 9 9 9 9 . . . .
9 9 9 9 9 9 9 9 9 9 9 9 9 9 9 9 . . . .
9 9 9 9 9 9 9 9 9 9 9 9 9 9 9 . . . . .
9 9 9 9 9 9 9 9 9 9 9 9 9 9 9 . . . . .
9 9 9 9 9 9 9 9 9 9 9 9 9 9 . . . . . .
9 9 9 9 9 9 9 9 9 9 . . . . . . . . . .
9 9 9 9 9 9 9 9 . . . . . . . . . . . .
9 9 9 9 9 9 9 9 . . . . . . . . . . . .
9 9 9 9 9 9 9 9 9 9 . . . . . . . . . .
9 9 9 9 9 9 9 9 9 9 9 . . . . . . . . .
9 9 9 9 9 9 9 9 9 9 9 . . . . . . . . .
9 9 9 9 9 9 9 9 9 9 9 . . . . . . . . .
9 9 9 9 9 9 9 9 9 9 9 . . . . . . . . .
9 9 9 9 9 9 9 9 9 9 . . . . . . . . . .
9 9 9 9 9 9 9 9 9 9 . . . . . . . . . .
9 9 9 9 9 9 9 9 9 9 . . . . . . . . . .
9 9 9 9 9 9 9 9 9 9 . . . . . . . . . .
Level 3
21 21 21 21 21 21 21 21 21 21 21 . . . . . . . . .
21 21 21 21 21 21 21 21 21 21 21 . . . . . . . . .
21 21 21 21 21 21 21 21 21 21 21 . . . . . . . . .
21 21 21 21 21 21 21 21 21 21 21 . . . . . . . . .
21 21 21 21 21 21 21 21 21 21 21 . . . . . . . . .
21 21 21 21 21 21 21 21 21 21 21 . . . . . . . . .
107 107 107 107 21 . . . . . . . . . . . . . . .
107 107 107 107 21 . . . . . . . . . . . . . . .
107 107 107 107 21 . . . . . . . . . . . . . . .
107 107 107 107 21 . . . . . . . . . . . . . . .
107 107 107 107 21 . . . . . . . . . . . . . . .
107 107 107 107 21 . . . . . . . . . . . . . . .
107 107 107 107 21 . . . . . . . . . . . . . . .
21 21 21 21 21 21 21 . . . . . . . . . . . . .
107 107 107 107 107 107 21 . . . . . . . . . . . . .
107 107 107 107 107 107 21 . . . . . . . . . . . . .
107 107 107 107 107 107 21 . . . . . . . . . . . . .
107 107 107 107 107 107 21 . . . . . . . . . . . . .
107 107 107 107 107 107 21 . . . . . . . . . . . . .
107 107 107 107 107 107 21 . . . . . . . . . . . . .
Level 4
107 107 107 107 107 . . . . . 21 . . . . . . . . .
107 107 107 107 107 . . . . . 21 . . . . . . . . .
107 107 107 107 107 . . . . . 21 . . . . . . . . .
107 107 107 107 107 . . . . . . . . . . . . . . .
107 107 107 107 107 . . . . . 21 . . . . . . . . .
21 21 21 21 21 21 21 21 21 21 21 . . . . . . . . .
107 107 107 107 21 . . . . . . . . . . . . . . .
107 107 107 107 21 . . . . . . . . . . . . . . .
107 107 107 107 21 . . . . . . . . . . . . . . .
107 107 107 107 . . . . . . . . . . . . . . . .
107 107 107 107 21 . . . . . . . . . . . . . . .
107 107 107 107 21 . . . . . . . . . . . . . . .
107 107 107 107 21 . . . . . . . . . . . . . . .
21 21 21 21 21 21 21 . . . . . . . . . . . . .
107 107 107 107 107 107 21 . . . . . . . . . . . . .
107 107 107 107 107 107 21 . . . . . . . . . . . . .
107 107 107 107 107 107 21 . . . . . . . . . . . . .
107 107 107 107 107 107 21 . . . . . . . . . . . . .
107 107 107 107 107 107 21 . . . . . . . . . . . . .
107 107 107 107 107 107 21 . . . . . . . . . . . . .
Level 5
. . . . . . . . . . . . . . . . . . . .
. . . . . . . . . . . . . . . . . . . .
. . . . . . . . . . . . . . . . . . . .
. . . . . . . . . . . . . . . . . . . .
. . . . . . . . . . . . . . . . . . . .
. . . . . . . . . . . . . . . . . . . .
. . . . . . . . . . . . . . . . . . . .
. . . . . . . . . . . . . . . . . . . .
. . . . . . . . 6 . . . . . . . . . . .
. . . e4 . . . . . . . . . . . . . . . .
. . . . . . . . . . . . . . . . . . . .
. . . . . . . . . . . . . . . . . . . .
. . . . . . . . . . . . . . . . . . . .
21 21 21 21 21 21 21 . . . . . . . . . . . . .
107 107 107 107 107 107 21 . . . . . . . . . . . . .
107 107 107 107 107 107 21 . . . . . . . . . . . . .
107 107 107 107 107 107 . . . . . . . . . . . . . .
107 107 107 107 107 107 21 . . . . . . . . . . . . .
107 107 107 107 107 107 21 . . . . . . . . . . . . .
107 107 107 107 107 107 21 . . . . . . . . . . . . .
Level 6
. . . . . . . . . . . . . . . . . . . .
. . . . . . . . . . . . . . . . . . . .
. . . . . . . . . . . . . . . . . . . .
. . . . . . . . . . . . . . . . . . . .
. . . . . . . . . . . . . . . . . . . .
. . . . . . . . . . . . . . . . . . . .
. . . . . . . . . . . . . . . . . . . .
. . . . . . . . . . . . . . . . . . . .
. . . . . . . . . . . . . . . . . . . .
. . . . . . . . . . . . . . . . . . . .
. . . . . . . . . . . . . . . . . . . .
. . . . . . . . . . . . . . . . . . . .
. . . . . . . . . . . . . . . . . . . .
21 21 21 21 21 21 21 . . . . . . . . . . . . .
107 107 107 107 107 107 21 . . . . . . . . . . . . .
107 107 107 107 107 107 21 . . . . . . . . . . . . .
107 107 107 107 107 107 21 . . . . . . . . . . . . .
107 107 107 107 107 107 21 . . . . . . . . . . . . .
107 107 107 107 107 107 21 . . . . . . . . . . . . .
107 107 107 107 107 107 21 . . . . . . . . . . . . .
Level 7
. . . . . . . . . . . . . . . . . . . .
. . . . . . . . . . . . . . . . . . . .
. . . . . . . . . . . . . . . . . . . .
. . . . . . . . . . . . . . . . . . . .
. . . . . . . . . . . . . . . . . . . .
. . . . . . . . . . . . . . . . . . . .
. . . . . . . . . . . . . . . . . . . .
. . . . . . . . . . . . . . . . . . . .
. . . . . . . . . . . . . . . . . . . .
. . . . . . . . . . . . . . . . . . . .
. . . . . . . . . . . . . . . . . . . .
. . . . . . . . . . . . . . . . . . . .
. . . . . . . . . . . . . . . . . . . .
. . . . . . . . . . . . . . . . . . . .
. . . . . . . . . . . . . . . . . . . .
. . . . . . . . . . . . . . . . . . . .
. . . . . . . . . . . . . . . . . . . .
. . . . . . . . . . . . . . . . . . . .
. . . . . . . . . . . . . . . . . . . .
. . . . . . . . . . . . . . . . . . . .
Level 8
. . . . . . . . . . . . . . . . . . . .
. . . . . . . . . . . . . . . . . . . .
. . . . . . . . . . . . . . . . . . . .
. . . . . . . . . . . . . . . . . . . .
. . . . . . . . . . . . . . . . . . . .
. . . . . . . . . . . . . . . . . . . .
. . . . . . . . . . . . . . . . . . . .
. . . . . . . . . . . . . . . . . . . .
. . . . . . . . . . . . . . . . . . . .
. . . . . . . . . . . . . . . . . . . .
. . . . . . . . . . . . . . . . . . . .
. . . . . . . . . . . . . . . . . . . .
. . . . . . . . . . . . . . . . . . . .
. . . . . . . . . . . . . . . . . . . .
. . . . . . . . . . . . . . . . . . . .
. . . . . . . . . . . . . . . . . . . .
. . . . . . . . . . . . . . . . . . . .
. . . . . . . . . . . . . . . . . . . .
. . . . . . . . . . . . . . . . . . . .
. . . . . . . . . . . . . . . . . . . .
Level 9
. . . . . . . . . . . . . . . . . . . .
. . . . . . . . . . . . . . . . . . . .
. . . . . . . . . . . . . . . . . . . .
. . . . . . . . . . . . . . . . . . . .
. . . . . . . . . . . . . . . . . . . .
. . . . . . . . . . . . . . . . . . . .
. . . . . . . . . . . . . . . . . . . .
. . . . . . . . . . . . . . . . . . . .
. . . . . . . . . . . . . . . . . . . .
. . . . . . . . . . . . . . . . . . . .
. . . . . . . . . . . . . . . . . . . .
. . . . . . . . . . . . . . . . . . . .
. . . . . . . . . . . . . . . . . . . .
. . . . . . . . . . . . . . . . . . . .
. . . . . . . . . . . . . . . . . . . .
. . . . . . . . . . . . . . . . . . . .
. . . . . . . . . . . . . . . . . . . .
. . . . . . . . . . . . . . . . . . . .
. . . . . . . . . . . . . . . . . . . .
. . . . . . . . . . . . . . . . . . . .
Level 10
. . . . . . . . . . . . . . . . . . . .
. . . . . . . . . . . . . . . . . . . .
. . . . . . . . . . . . . . . . . . . .
. . . . . . . . . . . . . . . . . . . .
. . . . . . . . . . . . . . . . . . . .
. . . . . . . . . . . . . . . . . . . .
. . . . . . . . . . . . . . . . . . . .
. . . . . . . . . . . . . . . . . . . .
. . . . . . . . . . . . . . . . . . . .
. . . . . . . . . . . . . . . . . . . .
. . . . . . . . . . . . . . . . . . . .
. . . . . . . . . . . . . . . . . . . .
. . . . . . . . . . . . . . . . . . . .
. . . . . . . . . . . . . . . . . . . .
. . . . . . . . . . . . . . . . . . . .
. . . . . . . . . . . . . . . . . . . .
. . . . . . . . . . . . . . . . . . . .
. . . . . . . . . . . . . . . . . . . .
. . . . . . . . . . . . . . . . . . . .
. . . . . . . . . . . . . . . . . . . .
Level 11
. . . . . . . . . . . . . . . . . . . .
. . . . . . . . . . . . . . . . . . . .
. . . . . . . . . . . . . . . . . . . .
. . . . . . . . . . . . . . . . . . . .
. . . . . . . . . . . . . . . . . . . .
. . . . . . . . . . . . . . . . . . . .
. . . . . . . . . . . . . . . . . . . .
. . . . . . . . . . . . . . . . . . . .
. . . . . . . . . . . . . . . . . . . .
. . . . . . . . . . . . . . . . . . . .
. . . . . . . . . . . . . . . . . . . .
. . . . . . . . . . . . . . . . . . . .
. . . . . . . . . . . . . . . . . . . .
. . . . . . . . . . . . . . . . . . . .
. . . . . . . . . . . . . . . . . . . .
. . . . . . . . . . . . . . . . . . . .
. . . . . . . . . . . . . . . . . . . .
. . . . . . . . . . . . . . . . . . . .
. . . . . . . . . . . . . . . . . . . .
. . . . . . . . . . . . . . . . . . . .
Level 12
. . . . . . . . . . . . . . . . . . . .
. . . . . . . . . . . . . . . . . . . .
. . . . . . . . . . . . . . . . . . . .
. . . . . . . . . . . . . . . . . . . .
. . . . . . . . . . . . . . . . . . . .
. . . . . . . . . . . . . . . . . . . .
. . . . . . . . . . . . . . . . . . . .
. . . . . . . . . . . . . . . . . . . .
. . . . . . . . . . . . . . . . . . . .
. . . . . . . . . . . . . . . . . . . .
. . . . . . . . . . . . . . . . . . . .
. . . . . . . . . . . . . . . . . . . .
. . . . . . . . . . . . . . . . . . . .
. . . . . . . . . . . . . . . . . . . .
. . . . . . . . . . . . . . . . . . . .
. . . . . . . . . . . . . . . . . . . .
. . . . . . . . . . . . . . . . . . . .
. . . . . . . . . . . . . . . . . . . .
. . . . . . . . . . . . . . . . . . . .
. . . . . . . . . . . . . . . . . . . .
Level 13
. . . . . . . . . . . . . . . . . . . .
. . . . . . . . . . . . . . . . . . . .
. . . . . . . . . . . . . . . . . . . .
. . . . . . . . . . . . . . . . . . . .
. . . . . . . . . . . . . . . . . . . .
. . . . . . . . . . . . . . . . . . . .
. . . . . . . . . . . . . . . . . . . .
. . . . . . . . . . . . . . . . . . . .
. . . . . . . . . . . . . . . . . . . .
. . . . . . . . . . . . . . . . . . . .
. . . . . . . . . . . . . . . . . . . .
. . . . . . . . . . . . . . . . . . . .
. . . . . . . . . . . . . . . . . . . .
. . . . . . . . . . . . . . . . . . . .
. . . . . . . . . . . . . . . . . . . .
. . . . . . . . . . . . . . . . . . . .
. . . . . . . . . . . . . . . . . . . .
. . . . . . . . . . . . . . . . . . . .
. . . . . . . . . . . . . . . . . . . .
. . . . . . . . . . . . . . . . . . . .
Level 14
. . . . . . . . . . . . . . . . . . . .
. . . . . . . . . . . . . . . . . . . .
. . . . . . . . . . . . . . . . . . . .
. . . . . . . . . . . . . . . . . . . .
. . . . . . . . . . . . . . . . . . . .
. . . . . . . . . . . . . . . . . . . .
. . . . . . . . . . . . . . . . . . . .
. . . . . . . . . . . . . . . . . . . .
. . . . . . . . . . . . . . . . . . . .
. . . . . . . . . . . . . . . . . . . .
. . . . . . . . . . . . . . . . . . . .
. . . . . . . . . . . . . . . . . . . .
. . . . . . . . . . . . . . . . . . . .
. . . . . . . . . . . . . . . . . . . .
. . . . . . . . . . . . . . . . . . . .
. . . . . . . . . . . . . . . . . . . .
. . . . . . . . . . . . . . . . . . . .
. . . . . . . . . . . . . . . . . . . .
. . . . . . . . . . . . . . . . . . . .
. . . . . . . . . . . . . . . . . . . .
