5 5 3
Level 0
0 1 2 0 1
1 2 0 1 2
2 0 1 2 0
0 1 2 0 1
1 2 0 1 2
Level 1
1 . . . .
. . . . .
. . . . .
. . . . .
. . . . .
Level 2
. . . . .
. . . . .
. . . . .
. . . . .
. . . . .